a little bit - немного
abandon - покидать, оставлять, отказываться
abbreviation - сокращение
aberration - отклонение
abhor - ненавидеть, не выносить
abide - оставаться верным, придерживаться
ability - способность, умение
abject - жалкий, униженный, несчастный
able - способный к чему-либо
abnormality - неправильность, ненормальность, аномалия
aboard - на борту, на борт
abolish - отменять, упразднять, уничтожать
abortion - аборт
abound - изобиловать, быть в большом количестве
abroad - за границей
abrupt - резкий, внезапный, крутой
absence - отсутствие
absent - отсутствующий
absorb - поглощать, впитывать
abstain - воздерживаться
absurd - нелепый, глупый, смехотворный
abundance - избыток, изобилие
abundant - обильный, изобилующий
abuse - злоупотреблять/злоупотребление
abuse - оскорблять, бранить/оскорбление, брань
abyss - бездна, пропасть, пучина
accelerate - ускорять
accept - принимать или допускать
acceptable - приемлемый, желанный
acceptance - принятие, признание
access - доступ
accessory - принадлежность, приспособление
accident - случай, случайность
accident - авария, ДТП
accidental - случайный/случайность
accommodate - приспосабливать, улаживать, согласовывать
accommodation - пристанище, ночлег
accompany - сопровождать, сопутствовать
accomplish - совершить, выполнить, довести до конца
accomplishment - достижение, свершение
accord - согласовывать, соответствовать/согласие, договорённость
accordance - согласие, соответствие
according - в соответствии с
accordingly - соответственно, таким образом
account - счёт в банке
account - мнение, оценка, рассмотрение/считать, рассматривать как
accountable - соответственный или объяснимый
accountant - бухгалтер
accumulate - накапливать(ся)
accuracy - точность
accurate - точный
accusation - обвинение
accuse - обвинять, винить
accustom - приучать
ache - болеть/боль
achieve - достигать, добиваться
achievement - достижение
acid - кислота/кислый, кислотный
acknowledge - сознавать, допускать, подтверждать
acquaintance - знакомство или знакомый человек
acquire - приобретать
acquisition - приобретение
acquit - оправдывать, освобождать
across - через
act - дело, поступок/действовать, поступать
action - дело, действие
active - деятельный
activity - деятельность
actor - актёр
actress - актриса
actual - существующий, действительный
actually - фактически, на самом деле
acute - острый, сильный, пронзительный
ad - объявление, реклама
adapt - приспосабливать(ся), переделывать
add - прибавлять,соединять
addict - увлекаться (дурным)/наркоман
addiction - привычка, пристрастие
addition - добавление, сложение, примесь
additional - дополнительный
address - обращаться/обращение, выступление
adequate - соответствующий, достаточный
adhere - приставать, прилипать, твёрдо держаться
adjective - имя прилагательное
adjust - приводить в порядок, улаживать, приспосабливать
adjustment - регулирование, приспособление
admirable - восхитительный
admiration - восхищение
admire - восхищаться, любоваться
admission - допущение, признание
admission - доступ
admit - допускать, признавать, соглашаться
adopt - принимать, усваивать
adoption - принятие, признание
adore - обожать, преклоняться
adorn - украшать
adult - взрослый
adultery - супружеская измена
advance - продвигаться вперёд/продвижение, прогресс, улучшение
advance - ссуда, аванс
advancement - продвижение
advantage - преимущество, выгода, польза
adventure - приключение, рискованное дело
adventurous - безрассудный, предприимчивый, рисковый
adverse - враждебный, неблагоприятный, вредный
adversity - бедствия, несчастья
advertise - рекламировать, помещать объявления
advertisement - объявление, реклама
advice - совет, консультация
advise - советовать, консультировать
advisory - совещательный, консультативный
advocate - выступать в защиту
affair - дело, занятия
affect - влиять
affection - привязанность, любовь
affectionate - нежный, любящий
affirm - утверждать, подтверждать
affirmative - утвердительный
afflict - беспокоить, тревожить, огорчать
afford - позволить себе
afraid - испуганный
afresh - заново
afternoon - время после полудня
afterwards - впоследствии, позже
against - против
age - возраст
age - век, эпоха
aggregate - совокупность/совокупный
aging - стареющий
agree - соглашаться или договариваться
agreeable - приемлемый, приятный
agreement - согласие или соглашение, договорённость
agriculture - сельское хозяйство
ahead - вперёд, впереди/будущий
aid - помощь, поддержка/помогать
ailment - нездоровье
aim - цель, намерение/целиться, стремиться
air - воздух
aircraft - самолёт или авиация
airline - авиалиния
airplane - самолёт
akin - сходный, близкий, похожий
alarm - будильник, тревога/дать тревогу, встревожить
alas - увы
alert - тревога/бдительный, настороженный/привести в состояние готовности
alien - иностранец/иностранный, чуждый
alight - сходить, высаживаться
alike - похожий, одинаковый/подобно, похоже
alimony - алименты, содержание
alive - живой, живущий, бодрый
allay - успокаивать (боль, волнение), ослаблять
allege - ссылаться, утверждать
allegiance - верность, лояльность
alliance - союз, общность, объединение
allow - позволять, допускать, признавать
ally - соединять/союзник
almighty - всемогущий
almost - почти, едва не
alone - один, одинокий, сам
alone - только лишь, исключительно
along - вперёд, вдоль
alongside - рядом, бок о бок
aloud - вслух, громко
already - уже
alter - изменять(ся), переделывать
alternative - взаимоисключающий, переменный/выбор, альтернатива
although - несмотря на то, что
altogether - полностью, всецело
amass - собирать, накапливать
amateur - любитель, дилетант/любительский
amaze - поражать, изумлять
amazing - удивительный, поразительный
ambassador - посол
ambition - честолюбие
ambitious - честолюбивый
ambulance - скорая помощь
ambush - засада
amenable - поддающийся, подверженный
amend - исправлять, улучшать
amendment - исправление, поправка
amiable - дружелюбный, добродушный, любезный
amid - среди, между
amiss - неверно, не туда, некстати
ammunition - боеприпасы
amount - количество, сумма/доходить до определённого значения
ample - обильный, достаточный, пространный
amuse - забавлять, развлекать
amusement - развлечение, забава, впремяпрепровождение
analysis - анализ
ancestor - предок
anchor - якорь/становиться на якорь
ancient - древний, старинный
anew - снова, заново
anger - гнев/злить, раздражать
angle - угол
angry - сердитый, раздражённый
anguish - мука, боль
animal - животное
animalism - чувственность
animate - оживлять, воодушелвять/живой, оживлённый
anniversary - годовщина, юбилей/ежегодный
announce - объявлять, публиковать, докладывать
announcement - объявление, сообщение, уведомление
annoy - надоедать, докучать
annual - ежегодный
answer - отвечать/ответ
ant - муравей
anthem - гимн, торжественная песнь
anticipate - ожидать
anticipation - ожидание
antidote - противоядие
antipathy - отвращение, несовместимость
anxiety - беспокойство, тревога
anxious - озабоченный, беспокоящийся
anyhow - как-нибудь
anymore - больше не, уже не
anyone - кто-нибудь, кто угодно
anyway - тем не менее, всё равно
apart - отдельно, в стороне, порознь
apartment - квартира
apathy - безразличие, вялость
ape - обезьяна (человекообразная)
apologize - приносить извинения
apology - извинение или оправдание
appal - пугать, устрашать
apparent - видимый, явный, очевидный
appeal - призыв, воззвание, обращение/взывать, обращаться
appear - производить впечатление, казаться
appear - появляться
appear - публично выступать
appearance - впечатление, внешний вид
appease - успокаивать, облечгать, утолять
applaud - одобрять или аплодировать
applause - одобрение или рукоплескания
appliance - приспособление, прибор
application - применение, употребление
apply - применять
appoint - назначать, определять, предписывать
appointment - назначение, определение
appraise - оценивать
appreciate - ценить
appreciation - оценка, понимание
approach - приближаться/приближение, подход
appropriate - подходящий, соответствующий
appropriation - присвоение, приобретение
approval - одобрение
approve - одобрять
apt - склонный, способный к чему-либо
arbitrary - произвольный, случайный
archive - архив
ardent - горящий, страстный, ревностный
arduous - сложный, труднодоступный, напряжённый (о деятельности)
area - площать, пространство, район, территория
argue - спорить, убеждать, доказывать
argument - спор, дискуссия или отдельный довод
arise - возникать, появляться, проистекать из
arm - рука, передняя лапа
arm - оружие/вооружать
armament - вооружение
armoury - арсенал
army - армия
arouse - будить, пробуждать(ся), возбуждать
arrange - налаживать, устраивать, приводить в порядок
arrangement - приведение в порядок, урегулирование, приспосабливание
arrest - задерживать
arrival - прибытие
arrive - прибывать, достигать, наступать (о событии)
arrogant - высокомерный, надменный
arrow - стрела, стрелка
art - искусство
artful - ловкий, хитрый
article - предмет, изделие, вещь
article - статья, заметка
artificial - искуственный
artist - художник или артист
as long as - то тех пор, пока
ascend - подниматься, восходить, набирать высоту
ash - пепел, зола
ashamed - пристыженный, стыдящийся
aside - в стороне, в сторону, отдельно
asleep - спящий
aspiration - стремление
aspire - стремиться
ass - осёл
ass - жопа
assail - атаковать, набрасываться, критиковать
assassin - убийца
assassinate - убить
assault - нападать, использовать физическое насилие/нападение, атака
assemble - собирать, созывать
assembly - собрание, агрегат
assert - утверждать, заявлять
assertion - утвердение, заявление
assess - определять налог, облагать налогом
asset - ценное имущество или ценное качество, свойство
asshole - мерзавец, негодяй
assign - назначать, определять, присваивать
assignment - назначение, задание
assist - помогать, принимать участие
assistance - помощь, содействие
associate - связываться, общаться/товарищ, компаньон
association - сообщество, ассоциация, общение
assume - преполагать, допускать
assume - принимать
assumption - предположение
assurance - уверенность, убеждённость
assure - уверять, убеждать
astonish - удивлять, изумлять
astonishment - удивление, изумление
astound - поражать, изумлять
astray - не туда, в другую сторону, заблудившись
asylum - приют или дурдом
at all - совсем, совершенно
at first - сперва, вначале
at least - по крайней мере
at once - сразу
atheist - безбожник
atrocity - злодеяние или что-то отвратительное
attach - прикреплять, присоединять, привязывать
attachment - привязанность
attack - нападать /нападение
attain - достигнуть, добиться
attempt - пытаться/попытка
attend - посещать, присутствовать
attend - уделять внимание, следить
attendant - сопровождающий/сопровождающее лицо
attention - внимание, внимательность
attentive - внимательный
attic - чердак
attitude - отношение к чему-либо
attorney - прокурор или поверенный адвокат
attract - привлекать
attraction - привлекательность или привлечение
attractive - привлекательный
attribute - приписывать, относить / свойство
audacious - смелый, дерзкий
audacity - смелость или наглость
audible - слышный, внятный, слышимый
audience - аудитория, те, кто смотрит
augment - увеличивать/увеличение
aunt - тётка
author - автор, писатель, создатель
authority - власть, полномочие
authorize - уполномочивать, оправдывать, давать право
autumn - осень
availability - доступность
available - доступный
avalanche - лавина
avarice - алчность
avenge - мстить
average - средний, обыкновенный
avert - отводить, отвлекать, отвращать
avoid - избегать
await - ожидать
awake - будить, пробуждать/бодрствующий
awakening - пробуждение
award - награждать/присуждение (награды, премии)
aware - знающий, осведомлённый
awareness - осознание
awe - страх, трепет/внушать страх
awesome - устрашающий, пугающий
awful - ужасный
awkward - неуклюжий или неудобный
axe - топор
babe - (разг.) малышка, красотка
baby - маленький ребёнок
bachelor - холостяк
back - спина, задняя сторона/задний/назад, обратно
back off - сторониться, отодвигаться
backbone - позвоночник
background - фон/фоновый
background - истоки, происхождение
backward - обратный/назад, наоборот
badly - очень сильно
baffle - ставить в тупик, расстраивать
bag - сумка
bail - залог, поручительство
bait - приманка, искушение/приманивать
bake - печь (хлеб), обжигать (глину)
balance - равновесие/сохранять равновесие
bald - лысый
ballot - бюллетень
balls - (разг.) яйца
ban - запрещать/запрет
band - ансамбль
band - лента
bang - удар, стук, звук взрыва/ударять, греметь
banish - изгонять, отгонять, прогонять
bank - берег (реки)
baptism - крещение
bar - полоса металла, прут, решетка (мн.ч)
barbarian - варвар/варварский
barber - парикмахер
bare - голый
barely - только, лишь, едва
bargain - торговаться
bark - лаять
bark - кора
barrel - бочка
barrier - преграда
bartender - бармен
base - основа/основывать (на)
baseless - безосновательный
basement - подвал или фундамент
bash - бить, ударять/удар
basic - основной
basically - в основном, по существу
basis - основание
basket - корзина
bastard - ублюдок
bath - ванна
bathe - купать, омывать/купание
bathroom - ванная комната
battle - бой
bay - бухта
be on fire - гореть, загореться
beans - бобы
bear - носить, переносить, выносить (терпеть)
bear - рожать
bear - медведь
bearable - терпимый, сносный
beard - борода
beast - зверь, скотина
beat - бить/удар
beauty - красота или красавица
become - становиться
bed - кровать
bedroom - спальня
bee - пчела
beef - говядина
beer - пиво
befall - случаться, происходить
beforehand - заблаговременно или преждевременно
beg - просить, умолять
beget - порождать
beggar - нищий
behalf - on smb's ~ - ради кого-либо, в чьи-либо интересах
behave - поступать, вести себя
behavior - поведение
behold - смотреть, видеть, замечать, созерцать
being - бытие или существо
belief - вера или убеждение
believable - правдоподобный, вероятный
believe - верить или полагать
believer - верующий
belittle - принижать
bell - колокол/звонить
belly - живот, брюхо
belong - принадлежать, относиться к чему-то
belongings - вещи, пожитки
below - ниже, внизу, под
belt - пояс/подпоясаться
bench - скамья
bend - гнуть, сгибаться
beneath - под, внизу
beneficial - благотворный
benefit - пенсия, пособие
benefit - польза, выгода/приносить пользу
benevolent - великодушный или благожелательный
berry - ягода
beside - рядом
besides - кроме
bet - пари/держать пари
betray - предавать, обманывать
beware - остерегаться
beyond - за, по ту сторону, вне
bias - склонять или оказывать влияние/уклон или предубеждение
Bible - Библия
bicycle - велосипед
bid - приглашать, предлагать
bill - счёт к оплате
bill - текст закона, законопроект
billboard - доска объявлений, афиша
billion - миллиард
bind - связывать, привязывать
birch - берёза
bird - птица
birth - рождение
birthday - день рождения
biscuit - печенье
bit - кусочек, небольшая часть
bitch - сука
bite - кусать/укус
bitter - горький
bizarre - странный, причудливый
blade - лезвие
blame - порицать, винить/упрёк
blank - пустой, чистый
blanket - одеяло
blast - взрыв или громкий звук / взрывать
blaze - пламя
bleak - открытый, голый, лишённый растительность
bleed - кровоточить, истекать кровью
blend - смешиваться или сочетаться/смесь
bless - благословлять
blind - слепой
blink - мерцать, блеснуть/мерцание, блеск
block - чурбан, колода
block - квартал
block - создавать препятствие
blockhead - болван
blonde - блондин(ка)
blood - кровь
bloom - расцветать/цвет, цветение
blossom - цвести, распускаться/цветение
blow - ударять/удар
blow - дуть/дуновение
blow up - взрывать, разрушать, взлетать на воздух
bluff - обман, запугивание, блеф/обманывать
blunder - ошибка, промах, просчёт/ошибаться
blunt - тупой
blur - пятно, клякса/затуманить, замарать, затемнить
blush - румянец/краснеть, заливаться румянцем
board - доска, полка, борт
boardroom - зал заседаний
boast - хвастаться/хвастовство
boat - лодка/кататься на лодке
bode - предвещать, сулить
body - тело
bodyguard - телохранитель
boil - кипеть или варить/кипение
bold - смелый, наглый, самоуверенный
bond - связь, оковы, соединение/связывать
bone - кость
bonfire - костёр
boobs - сиськи
book - заказывать (билет)
boon - благо, преимущество
boost - поднимать, повышать, поддерживать
boot - ботинок
booze - попойка/пьянствовать
border - граница/граничить
bore - зануда
boredom - скука
boring - скучный
born - прирождённый
borrow - занимать, брать в долг
bosom - недра, лоно, сердце, пазуха и т. д.
both - как один, так и другой, оба
bother - тревожиться, беспокоиться/беспокойство
bottle - бутылка
bottom - дно, низ или подножие холма
bounce - подпрыгнуть,отскочить/прыжок, отскок
bound - должен, вынужден
boundary - граница
bounty - щедрый подарок или правительственная премия
bow - сгибаться, кланяться, преклоняться/поклон
bow - лук (для стрельбы)
bowl - миска, чаша
box - коробка, ящик
brace - связывать, скреплять, укреплять
brag - хвастать/хвастун
brain - мозг, ум
brake - тормоз/тормозить
branch - ветвь, ответвление, отрасль
brass - латунь
brave - смелый/храбро встречать
bravery - мужество
breach - проламывать/пролом, разрыв
bread - хлеб
breadth - ширина, широта
break - ломать, разрушать
break down - провалиться, не получиться
break into - ворваться, вломиться
break up - распадаться
breakdown - провал, разрушение, катастрофа
breakfast - завтрак
breakthrough - прорыв
breakup - разрыв
breast - грудь
breath - дыхание, вздох
breathe - дышать
breed - порождать, разводить (животных)
bribe - взятка
brick - кирпич
bride - невеста
bridge - мост
bridle - узда/обуздывать, сдерживать
brief - краткий
bright - яркий, блестящий, светлый
brilliant - блестящий
brim - край (посуды)
bring - приносить,вносить
bring back - возвращать
brink - край, обрыв
brisk - живой, проворный
broad - широкий
broadcast - вещание/транслировать, передавать
broaden - расширять
broke - разорившийся
brook - ручей
broom - метла/подметать
brunette - брюнет(ка)
brush - щётка, кисть/чистить щёткой
brutal - жестокий, зверский
brutality - жестокость
brute - жестокий, грубый, животный/животное или грубый человек
bubble - пузырь, пузырёк
buck - (разг.) доллар
bucket - ведро
budge - шевелить или пошевельнуть
budget - бюджет
bug - жук
bugger - педераст
build - строить
building - здание
bulk - объём, количество
bull - бык
bullet - пуля
bullshit - ерунда, дерьмо, лажа
bully - хулиган, задира/задираться
bunch - связка, пучок, компания (разг.)
bundle - связка, пучок/связывать
burden - ноша, бремя/нагружать, отягощать
bureaucracy - бюрократия
burial - похороны, погребение
burn - жечь, сгорать, обжигать
burst - взрыв/взрываться
bury - хоронить
bus - автобус
bush - куст
business - дело или бизнес
bust - разрушать, ломать
bustle - суетиться/суета, суматоха
busy - занятый
but - только лишь
but - кроме, за исключением
butt - торец, зад
button - кнопка
button - пуговица
buy - покупать
buzz - жужжать, гудеть/жужжание, гудение
by chance - случайно
cab - такси
cabbage - капуста
cabin - хижина
cable - канат или кабель
cage - клетка/сажать в клетку
cake - пироженое
calculate - рассчитывать
calculation - рассчёт, обдумывание
calf - телёнок
call - звать
call - называть
call - звонить по телефону
calling - призвание
calm - спокойный/спокойствие/успокаивать
calmness - спокойствие, невозмутимость
camel - верблюд
camp - лагерь/разбивать лагерь
campaign - кампания
can - банка, жестяная коробка, бидон
cancel - отменить/отмена
cancer - рак (болезнь)
candle - свеча
candy - конфета
cannon - пушка
canvas - холст, полотно
cap - кепка, шляпа
capability - способность
capable - способный
capacity - вместимость, способность, мошность, производительность
capital - главный, основной, высший
captivate - пленять, очаровывать
captive - пленник
capture - захватывать/захват
car - автомобиль
cardboard - картон
care - беспокоиться, тревожиться
care - забота, уход
career - карьера
careful - осторожный, внимательный
careless - беззаботный, небрежный
cargo - груз
carpenter - плотник
carpet - ковёр
carry - носить, перевозить
carry out - доводить до конца, выполнять
cart - телега
cartoon - мультфильм
case - случай
case - судебный процесс
cash - наличные деньги
cash in - обналичивать или извлекать выгоду
cast - бросать
castle - замок
casual - случайный
casualty - несчастный случай или военные потери
catch - поймать, захватить
cattle - крупный рогатый скот
cause - причина/быть причиной
cause - дело
caution - осторожность, предусмотрительность
cautious - осторожный, предусмотрительный
cave - пещера
cease - прекращать
ceiling - потолок
celebrate - праздновать, отмечать
celebrity - знаменитость
cell - мобильный (телефон)
cell - (биол.) клетка
cellar - подвал, погреб
cemetery - кладбище
censorship - цензура
century - век
certain - определённый
certainty - определённость, уверенность
certify - удостоверять, ручаться
chain - цепь
chair - стул
chairman - председатель
chalk - мел
challenge - требовать
challenge - вызов, трудная задача
chance - случай, возможность
change - менять/перемена
changeable - изменчивый, поддающийся изменениям
channel - канал
chaos - хаос
chapter - глава
character - характер или качество
charge - обязанности, ответственность
charge - заряд/заряжать
charity - милосердие или благотворительность
charm - обаяние/очаровывать
charming - очаровательный
chase - гнаться, преследовать/преследование
chastity - целомудрие, воздержание
chat - разговор/болтать
cheap - дешёвый
cheat - обманывать/обман
check - проверять/проверка
cheek - щека
cheer - ободрить, поощрить
cheerful - бодрый, весёлый
cheese - сыр
chemical - химический
chemistry - химия
cherish - лелеять, хранить, дорожить
cherry - вишня
chess - шахматы
chest - сундук, ящик
chew - жевать
chicken - цыплёнок
chief - руководитель/главный
childhood - детство
chill - холод или простуда
chin - подбородок
chink - звон/звякать
chip - щепка
choice - выбор
choke - душить
choose - выбирать
chop - рубить
chorus - хор
christian - христианин/христианский
christmas - рождество
chunk - кусок
church - церковь
cinema - кино, кинематограф
circle - круг или окружность/двигаться по кругу
circuit - объезд, контур, электрическая цепь
circumstance - обстоятельство
cite - ссылаться, цитировать
citizen - гражданин
city - большой город
civic - гражданский
civil - гражданский или вежливый
civilian - гражданский
claim - заявлять
claim - требовать/требование
clap - хлопать/хлопок, удар
clarify - вносить ясность
clash - столкновение/сталкиваться
clay - глина
clean - чистый/чистить
clear - ясный, чистый/разъяснять, очищать
clearly - очевидно, несомненно
clergy - духовенство
cleric - церковник, духовное лицо
clerk - конторский служащий или чиновник
click - щёлкать/щелчок
climate - климат
climb - подъём, восхождение/взбираться, подниматься
cling - цепляться, держаться
clip - отрезать, отсекать
clock - часы
clockwise - по часовой стрелке
close - близкий
close - закрытый/закрывать
closet - чулан, кладовка
cloth - ткань
clothes - одежда
clothing - одежда
cloud - облако
club - дубинка
clue - идея, ход мыслей
clumsy - неуклюжий
coach - тренер, инструктор
coal - уголь
coast - морской берег
coat - пальто
coating - покрытие
coax - упрашивать, добиваться
cobweb - паутина
cock - петух
coffin - гроб
coherent - последовательный, согласованный, связный
coin - монета
coincide - совпадать
coincidence - совпадение
cold - холодный/холод
collaborate - сотрудничать
collaboration - сотрудничество
collapse - разрушаться, обваливаться/обрушение, гибель
collar - воротник, ошейник, хомут
collect - собирать
collective - совместный
collide - сталкиваться
collision - столкновение
color - цвет/окрашивать
comb - причёсывать/гребень
combat - битва, сражение
combination - сочетание
combine - сочетать, совмещать
come about - произойти, случиться
come across - случайно встретиться
come along - продолжать усердно работать
come to light - обнаружиться
come to pass - произойти, случиться
come true - осуществиться
comeback - возвращение
comfort - утешать/утешение
comfort - покой, отдых, удобство
comfortable - удобный
comma - запятая
commandment - заповедь, приказ
commend - хвалить
comment - замечание, отзыв/делать замечание
commerce - торговля
commission - совершение чего-либо
commit - совершать (напр. преступление)
commitment - обязательство
commitment - совершение, исполнение
committee - комитет, комиссия
commodity - товар
common - общий
common - обычный, распространённый
commonly - обычно
commonplace - банальный, заурядный
commonwealth - государство, федерация, содружество
communicate - общаться или сообщать, передавать
communication - общение
community - община, общество
companion - товарищ, спутник
comparable - сравнимый, сопоставимый
compare - сравнивать
comparison - сравнение
compassion - сострадание, сочувствие
compatible - совместимый
compel - принуждать, заставлять
compete - соревноваться, конкурировать
competence - способность, умение
competent - знающий, умелый
competition - соревнование, конкуренция
competitive - конкурентоспособный
competitor - конкурент
compile - составлять, собирать
complain - жаловаться
complaint - жалоба
complete - полный
completion - завершение, окончание
complex - сложный
complexity - сложность
compliance - согласие, уступчивость
complicate - усложнять
complicated - сложный
complication - сложность, запутанность
comply - уступить, подчиниться
compose - составлять, собирать
compound - составлять/смесь
comprehend - понимать, постигать
comprehensible - понятный, постижимый
comprehension - понимание
comprehensive - исчерпывающий, понятный
comrade - товарищ
concave - вогнутый, впалый
conceal - скрывать
concealment - утаивание
concede - уступать, признавать, допускать
conceit - самомнение, тщеславие, чванство
conceited - самодовольный
conceivable - мыслимый, возможный
conceive - постигать, понимать
concentrate - сосредоточиться
concentration - сосредоточение
concept - понятие, идея
concern - касаться, иметь отношение
concern - заботиться, беспокоиться/забота
concession - уступка
conclude - делать вывод
conclusion - вывод
concrete - бетон/бетонный
condemn - осуждать
condition - условие
conduct - вести/поведение
confess - признаваться
confession - признание
confide - доверять, вверять
confidence - доверие, уверенность
confident - уверенный
confine - ограничивать
confirm - подтверждать, укреплять
confirmation - подтверждение
confirmed - закоренелый, убеждённый
conform - соответствовать
confound - смешивать, спутывать, ставить в тупик
confront - смотреть в лицо, противостоять
confuse - путать, принимать одно за другое
confusion - путаница, беспорядок
conjecture - догадка, предположение/догадываться
connect - соединяться, связываться
connection - связь, соединение
conquer - завоевать
conquest - завоевание
conscience - совесть
conscious - сознательный, сознающий
consecutive - последовательный
consent - соглашаться/согласие
consequence - последствие
conservative - консерватор/консервативны
consider - считать за, рассматривать как
considerable - значительный, большой
considerate - внимательный к другим, тактичный
consideration - внимание к другим
consist - состоять из, заключаться в
consistency - последовательность, постоянство
consistent - последовательный, согласованный
consolation - утешение
console - утешать
consolidation - укрепление, затвердевание
conspiracy - заговор
conspire - тайно замышлять
constant - постоянный
constitute - составлять
construct - строить, создавать
construction - стройка
consult - советоваться, совещаться
consume - потреблять, поглощать
consumer - потребитель
consumption - потребление
contact - отношение, связь, взаимодействие/соприкосаться, взаимодействовать
contain - содержать в себе
contemplate - созерцать, рассматривать
contemporary - современный/современник
contempt - презрение, неуважение
contend - бороться, соперничать
content - содержание
content - удовлетворять/удовлетворение
contention - спор, борьба
contentious - спорный или вздорный (человек)
contest - состязание, соперничество/отстаивать
contingency - случайность, непредвиденное обстоятельство
continual - постоянный, непрерывный
continuation - продолжение или возобновление
continue - продолжать, длиться
continuous - непрерывный
contract - сжимать, сокращать
contradict - противоречить
contradiction - противоречие
contrary - вопреки, наоборот
contribute - делать вклад, жертвовать
contribution - вклад, пожертвование
contrive - придумывать, замышлять, изобретать
control - управление, надзор/управлять, присматривать
controversial - спорный
controversy - спор, дискуссия
convenience - удобство
convenient - удобный, пригодный
conventional - общепринятый
conversation - разговор, беседа
converse - разговаривать
conversion - изменение, преобразование
convert - превращать, переделывать
convex - выпуклый
convey - перевозить, передавать
convict - осуждённый
conviction - убеждение
convince - убеждать
cook - готовить (еду)/повар
cool - прохладный/прохлада/охлаждать
cooperate - сотрудничать
cooperation - сотрудничество
cop - полицейский
cope - справиться
copper - медь
copy - экземпляр или рукопись
cord - шнурок, верёвка
core - сердцевина, ядро, суть
corn - зерно
corner - угол
corny - банальный
corpse - труп
correct - правильный/поправлять
correctness - правильность
correspond - соотвествовать, соотноситься
corrode - разъедать, вытравливать
corrupt - портиться/испорченный или коррумпированный
corruption - разложение
cost - цена/стоить
costly - дорогой
cotton - хлопок
couch - диван
cough - кашель/кашлять
council - совет, совещание
counsel - совет/совещаться
count - иметь значение
count - считать (по числам)/счёт
count on - рассчитывать на
countenance - спокойствие, самообладание
counter - противное, обратное/противостоять
counter - прилавок, стойка
counterfeit - подделка/подделывать/поддельный
countless - бесчисленный
country - страна
countryside - сельская местность, округа
couple - пара
courage - мужество
course - ход, направление, течение дел
court - суд
courteous - вежливый, учтивый
courtesy - учтивость, обходительность
cover - покрывать, скрывать
coverage - охват зоны действия или освещение в сми
cow - корова
coward - трус
cowardice - трусость
crack - раскалываться, ломаться/треск, трещина
cradle - колыбель
craft - ремесло, умение
crap - ерунда, дерьмо
crash - разбить, разрушить
crave - желать, жаждать
crawl - ползать
crazy - сумасшедший
cream - сливки, крем
create - создавать
creation - создание
creative - творческий
creature - создание, существо
credibility - вероятность, правдоподобие
credible - вероятный, заслуживающий доверия
credit - честь, репутация
creed - вероучение или убеждение
creep - ползать, пресмыкаться
crew - команда (судна) или шайка
crime - преступление
criminal - преступный/преступник
cripple - калека/уродовать
criticize - критиковать, осуждать
crooked - изогнутый, кривой
crop - урожай/собирать урожай
cross - крест
cross - пересекать/пересекающийся
crotch - развилка, разветвление
crouch - припасть к земле, ползти
crow - ворона
crowd - толпа/собираться в толпу
crown - корона
crucial - решающий, критический
crude - грубый, сырой, непродуманный
cruel - жестокий
cruelty - жестокость
crumble - осыпаться, обваливаться
crumbs - крошки
crusade - крестовый поход
crush - раздавить, уничтожить
cry - кричать или плакать
cucumber - огурец
cunning - хитрый/хитрость
cup - чашка или кубок
curb - обуздывать/узда
curb - бордюр
cure - лечить/средство от..
curiosity - любопытство
curious - любопытный
curl - завиваться, виться, скручиваться
currency - валюта, деньги
current - поток, течение, ход вещей/текущий
curse - проклятие/проклинать
curtain - занавеска или занавес
curve - изгиб, кривизна, закругление/загибать
custom - обычай, привычка
customer - клиент
cut - резать, рубить
cute - привлекательный, миловидный
cynical - циничный
dad - папа
dagger - кинжал
daily - ежедневный
damage - вред, убыток/повреждать, портить
damn - проклясть, ругать/проклятие, ругань
dandy - превосходный
danger - опасность
dangerous - опасный
dangle - висеть, свисать
dare - осмелиться
daring - смелый, дерзкий
dark - тёмный/темнота
darkness - темнота
darling - дорогой, любимый (обращение)
dart - бросок, рывок/броситься
dash - примесь, немного чего-либо
data - данные, информация
date - свидание
dawn - рассвет
dead - мёртвый
dead - совершенно, полностью
deadline - крайний срок
deadly - ужасно, чрезвычайно
deaf - глухой
deal - иметь дело с
deal - некоторое количество
dealer - торговец
dear - дорогой, милый
death - смерть
debate - спор/обсуждать, оспаривать
debt - долг
decade - десятилетие
decay - разрушится, сгнить/разрушение, распад
deceit - обман
deceitful - лживый
deceive - обманывать
decency - приличие, достоинство
decent - приличный, порядочный
deception - обман
deceptive - обманчивый
decide - решать, принимать решение
decision - решение
decisive - решающий или решительный
deck - палуба или пол в автобусе
declare - объявить, заявить
decline - отказываться, отклонять предложение
decline - падение, упадок/клониться, идти к концу
decorate - украшать
decrease - уменьшать/уменьшение
decree - решение, определение, указ
decrepit - дряхлый, ветхий
dedicated - преданный, убеждённый
dedication - преданность
deduct - отнимать, вычитать
deed - дело, поступок
deem - полагать, считать
deep - глубокий
deer - олень
defeat - поражение/наносить поражение
defend - защищать
defense - защита
defer - откладывать
deficiency - нехватка, неполноценность
define - определять
definitely - определённо
definition - определение
defy - игнорировать, пренебрегать
degenerate - вырождаться/выродившийся
degrade - убавлять, уменьшать, приходить в упадок
degree - степень, ступень, порядок
delay - откладывать/отсрочка
delete - убрать, вычеркнуть
deliberate - обдумывать/обдуманный
deliberation - раздумия
delicate - тонкий, искусный, деликатный
delicious - восхитительный, прелестный
delight - удовольствие, восторг/наслаждаться
deliver - произносить
deliver - доставлять, привозить
delivery - доставка
delude - вводить в заблуждение, обманывать
delusion - обман
demand - (экон.) спрос
demand - требовать/требование
demean - унижать
demonstrate - доказывать, показывать
den - логово, берлога, нора
denial - отрицание, отказ, опровержение, отречение
denote - означать
denounce - обвинять, осуждать, поносить
dense - густой, плотный
deny - отрицать
depart - уходить, отбывать
departure - отправление, отъезд, уход
depend - зависеть
dependence - зависимость
dependent - зависимый
depict - изображать, описывать
depose - смещать, свергать
deposit - вклад/вкладывать
depress - подавлять, вводить в уныние
depression - снижение, падение, (экон.) депрессия
deprive - лишать
depth - глубина
deputy - депутат
derive - происходить из
descend - происходить от
descend - спускаться
descendant - потомок
descent - спуск
describe - описывать, изображать
description - описание
desert - пустыня
desert - бросать, оставлять
deserve - заслуживать
design - замысел, план/предназначать, задумывать
designate - называть, обозначать
desirable - желательный
desire - желать/желание
desk - стол (письменный)
despair - отчаяние/отчаиваться
desperate - отчаянный, безнадёжный
desperation - безумство или отчаяние
despise - презирать
despite - несмотря
destination - пункт назначения, цель
destine - назначать, предопределять
destiny - судьба, удел
destroy - разрушать, уничтожать
destruction - разрушение
destructive - разрушительный
detach - отделять, отвязывать
detachment - отделение или отчуждённость
detail - подробность, деталь
detain - задерживать
detect - открыть, обнаружить
deter - удержать от чего-либо, помешать
determination - определение, определённость, решимость
determine - определять
determined - определённый или решительный
detest - ненавидеть, питать отвращение
devastate - опустошать, разорять
develop - развивать(ся)
development - развитие
device - средство, приспособление, инструмент
devil - чёрт
devise - придумывать, изобретать
devoid - лишённый
devote - посвящать, уделять чему-либо
devotion - преданность, увлечение
devour - пожирать
diamond - бриллиант
diary - дневник
dictionary - словарь
die - умирать
diet - диета
differ - отличаться
difference - разница
different - разный, другой
difficult - трудный, сложный
difficulty - трудность, сложность
diffuse - рассеивать, распространять
dig - копать
digest - переваривать
dignity - достоинство, благородство, титул
diligence - усердие, прилежание
dilute - разбавлять
dim - тусклый
diminish - уменьшать, ослаблять, принижать
dine - обедать
dinner - обед
dip - погрузить, окунуть/погружение
dire - ужасный, полный, крайний
direct - направлять
direct - прямой
direction - направление
dirt - грязь
dirty - грязный
disability - неспособность или нетрудоспособность
disabled - инвалид
disagree - не соглашаться
disagreeable - неприятный
disappear - исчезать
disappearance - исчезновение
disappoint - разочаровывать
disappointment - разочарование
disaster - беда, несчастье
disastrous - бедственный, гибельный
discard - отбрасывать
discharge - разгрузиться, разрядить, сбросить
disciple - ученик, последователь
disclaim - отрицать, не признавать
disclose - обнаруживать, раскрывать
disclosure - обнаружение, разоблачение
disconnect - разъединять, разобщать
discontent - недовольство, неудовлетворённость
discount - скидка
discourage - обескураживать, отговаривать, расхолаживать
discourse - рассуждение, лекция, доклад
discourtesy - невоспитанность, невежливость
discover - открывать, узнавать
discovery - открытие
discredit - позорить
discreet - осторожный, благоразумный
discretion - благоразумие
discriminate - отличать, выделять одно от другого
discuss - обсуждать
discussion - обсуждение
disdain - презирать/презрение
disease - болезнь
disfavor - немилость, неодобрение
disgrace - позор, бесчестие/позорить
disguise - маскировка, маска/маскировать
disgust - отвращение
dish - блюдо
dishearten - приводить в уныние
dislike - не любить/нелюбовь
dismiss - отпустить, прогнать, избавиться, отбросить
disobedience - неповиновение
disobey - не повиноваться
disorder - беспорядок/приводить в беспорядок
disorderly - беспорядочный (человек)
disparity - неравенство, несоответствие
dispel - разгонять, рассеивать
dispense - распределять
dispense with - обходиться без
disperse - разгонять или расходиться
display - показывать, проявлять
displease - не нравиться, раздражать
disposal - расположение
dispose - располагать
dispute - спор, дебаты/обсуждать, спорить
disregard - не обращать внимания/равнодушие, игнорирование
disrespect - неуважение/относиться непочтительно
dissatisfy - не удовлетворять
dissent - разногласие/расходиться во мнениях
dissipate - рассеять, разогнать
dissolve - растворяться
distance - расстояние
distant - дальний
distaste - неприязнь/не любить
distinct - отдельный, особый, отчётливый
distinction - различие
distinguish - различать
distort - искажать
distract - отвлекать
distress - горе, страдание/причинять страдание
distribute - распределять
distribution - распределение
district - район, округ
distrust - не доверять/недоверие
disturb - беспокоить, тревожить
disturbance - нарушение, тревога, беспокойство
ditch - канава, яма
dive - нырять/ныряние
diverse - иной, разный, разнообразный
diversity - многообразие
divert - отводить, отвлекать
divide - делить, отделять, разделять
divine - божественный
division - разделение
divorce - развод
do without - обходиться без
dock - пристань
dodge - убежать, увернуться
dole - скупо выделять
domain - область, сфера
dominant - преобладающий, господствующий
dominate - преобладать
domination - господство, преобладание
dominion - владение или власть
donate - дарить, жертвовать
donation - дар, пожертвование
donkey - осёл
doom - обрекать, осуждать на/рок, судьба
doorstep - порог
doorway - дверной проём или путь к чему-либо (перен.)
dope - (разг.) наркотик
dot - точка или пятнышко
double - двойной/удваивать
doubt - сомнение/сомневаться
doubtful - сомнительный
doubtless - несомненный
downfall - падение, гибель
downstairs - вниз, на нижний этаж
downward - ухудшающийся, нисходящий
dozen - дюжина
draft - план, проект, набросок/составлять план и т. д.
drag - тащить
dragon - дракон
drain - водосток, канализация/осушать
drastic - решительный, крутой, радикальный
draw - тянуть, вытягивать, выводить (заключение)
drawback - препятствие или недостаток
drawer - ящик стола
dread - страх/бояться
dreadful - ужасный
dream - мечта/мечтать
dream - сон/видеть сон
dress - одежда/одеваться
drill - сверлить, бурить/сверло
drip - капать/капанье
drive - вести машину
drive - вести, гнать, приводить
drop - капля/капать
drop - падать, ронять, бросать вниз
drought - засуха
drown - тонуть или топить
drug - наркотик
drum - барабан
drunk - пьяный
drunkard - пьяница
drunkenness - пьянство
dry - сухой
duck - утка
dude - чувак
due - должное, то, что причитается
due - обусловленный
dull - скучный
dull - тупой
dumb - (разг.) тупой, глупый
dump - свалка/сваливать
dupe - простофиля, жертва обмана/обманывать
duplicate - копия, дубликат
duplicity - двуличие
durable - надёжный, долговременный
duration - продолжительность
during - во время
dust - пыль, прах
duty - долг
dwarf - карлик или гном
dwell - жить, обитать
dye - окрашивать/краска
dynamic - активный, энергичный
each - каждый
each other - друг друга (-ом, -у, -е)
eager - сильно желающий, нетерпеливый, энергичный
eagerness - рвение
eagle - орёл
ear - ухо
early - ранний/рано
earn - зарабатывать или заслуживать
earnest - серьёзный
earnings - заработок
earring - серьга
earth - земля
earthquake - землетрясение
ease - лёгкость
east - восток
echo - эхо
eclipse - затмевать/затмение
economics - экономика (наука)
economy - экономика (хозяйство)
ecstasy - восторг, экстаз
edge - край
edgy - раздражительный
edible - съедобный
edify - поучать, наставлять
edit - редактировать, готовить к изданию
educate - воспитывать, тренировать, учить
education - образование
effect - следствие, результат/выполнять, совершать
effective - действующий, действенный
efficiency - действенность, результативность
efficient - действенный, продуктивный
effort - усилие или достижение
egg - яйцо
either - также (при отрицании)
either - один из двух, тот или другой
elaborate - продуманный, разработанный/тщательно разрабатывать
elbow - локоть
elder - старший (в семье)
elect - избирать на должность
election - выборы
electricity - электричество
elephant - слон
elevator - лифт
eligible - подходящий, желательный
eliminate - устранять, ликвидировать
elimination - устранение
eloquence - красноречие
eloquent - красноречивый, выразительный
else - ещё, кроме/другой
elsewhere - где-то ещё
embark - отправляться, грузиться (на корабль)
embarrass - смущать, приводить в замешательство
embarrassment - затруднение, препятствие, замешательство
embassy - посольство
embrace - охватывать, включать в себя или обнимать
emerge - появляться, возникать
emergency - критическое положение или непредвиденный случай
eminent - выдающийся
emperor - император
emphasis - выразительность
empire - империя
employ - нанимать
employee - работник
employer - работодатель
employment - служба, занятие, применение
empty - пустой/опустошать
enable - давать возможность
enact - вводить закон, предписывать
enchant - очаровывать
enclose - окружать, заключать
encounter - встреча/неожиданно встретить
encourage - ободрять, поощрять, подстрекать
end up - оканчиваться (чем-либо)
endanger - подвергать опасности
endeavor - попытка, старание/стараться, прилагать усилия
endless - бесконечный
endorse - одобрять
endowment - дарование
endpoint - конечный результат, конечная точка
endurance - выносливость, стойкость
endure - выносить, терпеть
endure - длиться, продолжаться
enemy - враг
energetic - энергичный
enfold - заворачивать
enforce - заставлять, принуждать
engage - заниматься
engagement - дело, занятие, свидание, встреча
engine - двигатель
engineering - техника, машины
engross - поглощать, занимать
engulf - поглощать
enhance - усиливать
enigma - загадка
enjoy - наслаждаться
enjoyment - наслаждение
enlarge - расширять, увеличивать
enmity - вражда, неприязнь
enormous - огромный
enough - достаточно, вполне
enrich - обогащать
ensue - получаться в результате, следовать
ensure - обеспечивать, гарантировать
entail - влечь за собой
entangle - запутывать
enter - входить или вступать
enterprise - предприятие, предприимчивость или предпринимательство
entertain - развлечь
entertainment - развлечение
entire - весь, целый
entirely - всецело, полностью
entitle - давать право
entity - сущность, нечто реальное
entrance - вход
entrust - вверять
entry - вход
envelope - конверт или обложка
envious - завистливый
environment - окружающая среда
environmental - относящийся к окружающей среде
envoy - посланник, доверенное лицо
envy - зависть/завидовать
equal - равный/быть равным или делать равными
equality - равенство
equalize - уравнивать
equilibrium - равновесие
equip - снаряжать, экипировать
equipment - оснащение, оборудование
equitable - справедливый, беспристрастный
erase - стирать, счищать, сглаживать
erect - прямой, вертикальный/сооружать, воздвигать
erode - разъедать
err - ошибаться
errand - поручение, командировка
error - ошибка
escape - избежать, спастись/избежание
especially - особенно
espionage - шпионаж
essence - сущность, основа
essential - необходимый, существенный/неотъемлемая часть
establish - основывать, устанавливать
establishment - учреждение, ведомство
estate - имущество
esteem - уважение/уважать
estimate - оценка/оценивать
eternal - вечный, неизменный
eternity - вечность
evade - избегать, уклоняться
evaluate - оценивать
evaluation - оценка
even - даже
even - ровный
event - событие
eventually - в конце концов
ever - когда-либо
everlasting - вечный, длительный
everyone - каждый
everywhere - везде
evidence - доказательство
evident - очевидный
evil - злой/зло
evolve - развивать(ся), эволюционировать
exact - точный
exaggerate - преувеличивать
exaggeration - преувеличение
exalted - возвышенный, благородный
examination - экзамен или допрос
examine - исследовать, расследовать, допрашивать
example - пример
exceed - превышать, превосходить
excel - превосходить, выделяться
excellence - превосходство
excellent - превосходный
excellent - превосходный, отличный
except - кроме, за исключением/исключать
exception - исключение
exceptional - исключительный
excess - избыток
excessive - чрезмерный
exchange - обмен/обменивать
excite - возбуждать, волновать
excitement - возбуждение, волнение
exclamation - восклицание
exclamation point - восклицательный знак
exclude - исключать
exclusion - исключение
excusable - простительный
excuse - извинение, оправдание/извинить
excuse - повод
execute - выполнить
execution - выполнение
execution - казнь
executive - должностное лицо, руководитель/исполнительный
exempt - свободный от чего-либо/освобождать
exercise - упражнение/упражняться
exert - напрягать
exertion - напряжение
exhaust - истощать, выматывать
exhaustion - изнеможение
exhibit - показывать, проявлять, выставлять
exile - изгнание, ссылка/изгонять
exist - существовать
existence - существование
existent - существующий, проиходящий
exit - выход
expand - расширять(ся)
expansion - расширение, экспансия
expect - ожидать, рассчитывать, надеяться
expectation - ожидание
expel - выгонять, исключать, выбрасывать
expenditure - трата, расход
expense - трата, расход
expensive - дорогой
experience - опыт/испытывать
experienced - опытный
expert - знаток
expertise - знания, опыт
expire - выдыхаться, кончаться, угасать
explain - объяснять
explanation - объяснение
explicit - ясный, явный
explode - взрывать
exploit - эксплутатировать
explore - исследовать
explosion - взрыв, вспышка
explosive - взрывчатый или взрывной/взрывчатка
expose - подвергать
exposure - подвергание, выставление
express - выражать
expression - выражение
extend - расширяться, распространяться
extension - расширение
extensive - обширный, пространный
extent - протяжение, степень, мера
exterior - внешний/внешний вид
exterminate - искоренять, истреблять
external - наружный, внешний
extinct - вымерший
extinction - вымирание
extinguish - угасать
extra - лишний, дополнительный
extract - извлекать
extraordinary - необычайный, выдающийся
extreme - крайний
eyebrow - бровь
eyeglasses - очки
fable - басня, миф, легенда
fabric - ткань, материал
fabulous - невероятный, легендарный
face - встречаться, сталкиваться
facility - лёгкость, удобство
factory - завод
faculty - способность, дар
fade - увядать, угасать, блекнуть
fail - потерпеть неудачу
failure - неудача, провал или неудачник
faint - слабый, недостаточный
fair - прекрасный
fair - честный, справедливый
fairy - воображаемый, сказочный
faith - вера или верность
faithful - верный, преданный
fake - подделывать/подделка/подделывать
fall - падать, опускаться
fall - осень (амер.)
fall apart - развалиться
fall in love with - влюбиться
fall out - ссориться
fall over - споткнуться
fallacy - ошибка, заблуждение
false - ложный
falsehood - ложь, неправда
falsity - ложность
falter - спотыкаться, запинаться, колебаться
fame - слава
familiar - знакомый, известный
famine - голод
famous - знаменитый
fancy - фантазировать/фантазия
fancy - полагать, предполагать
far - дальний
faraway - далёкий
fare - плата за проезд
farewell - прощай!
farm - ферма
farther - дальше
fascinating - очаровательный
fascination - прелесть, очарование
fascist - фашистский/фашист
fashion - мода
fashionable - модный
fast - быстрый
fasten - прикреплять, завязывать
fat - жирный/жир
fatal - роковой, губительный
fate - судьба, удел
fat-free - обезжиренный
fatigue - усталость, утомление
faucet - водопроводный кран
fault - вина
fault - недостаток
faultless - безупречный
favor - услуга, помощь
favor - польза, интерес ("в ч-л. пользу")
favorable - благоприятный
favorite - любимый
fear - страх/бояться
fearful - боязливый
fearless - бесстрашный
feast - праздник или пир/праздновать
feat - проявление большого умения или подвиг
feather - перо
feature - особенность, черта
fee - гонорар, вознаграждение
feeble - слабый
feed - кормить/кормление
feed on - питаться
feel - чувствовать
feel - щупать
feel like - хотеть
feeling - чувство
feign - притворяться, симулировать
fellow - товарищ или просто чувак
female - женский/женщина, самка
fence - забор
ferocious - свирепый
ferry - перевоз, переправа/перевозить
fertile - плодородный, плодовитый
fetch - принести, привести, достать
fever - жар, лихорадка
few - немногие, мало кто
fiction - вымысел или художественная литература
fiddle - скрипка
fidelity - верность
field - область знаний
field - поле
fierce - свирепый
fiery - огненный, горящий, пламенный
fight - драться, бороться/бой, драка, спор, борьба
figure - цифра
figure out - понять, уяснить
file - предоставлять, подавать документ
fill - заполнять
filthy - грязный, мерзкий, дерьмовый
final - последний
find oneself - оказаться
find out - выяснить, узнать
fine - тонкий
fine - хороший, годный
fine - штраф, пеня
finger - палец
finite - ограниченный, конечный
fire - огонь/зажигать
fire - увольнять
firearms - огнестрельное оружие
fireman - пожарник
firm - твёрдый, крепкий
fish - рыба
fisherman - рыболов
fishing - рыбалка
fist - кулак
fit - годный, подходящий/подходить по размеру
fix - укреплять, устанавливать
fix - уладить
flag - ослабевать, уменьшаться
flair - чутьё, способность
flakes - хлопья
flame - пламя
flash - сверкать, вспыхивать/сверкание
flat - плоский
flatter - льстить
flattery - лесть
flavor - вкус или аромат
flaw - порок, брак, недостаток
flea - блоха
flee - бежать, спасаться бегством или избегать
fleet - флот или флотилия
flesh - плоть, тело, мясо
flexibility - гибкость
flexible - гибкий
flight - полёт
fling - бросать
float - плавать, всплывать
flock - стадо
flood - поток, наводнение/затоплять
floor - пол
flop - провал/провалиться, потерпеть неудачу
flour - мука
flourish - процветать
flow - поток, течение/течь
flower - цветок
fluent - гладкий, беглый, текущий
fluid - жидкий, текучий, меняющийся
flunk - провалиться (на экзамене)/провал
flurry - беспокойство/волновать
flush - прилив, поток/лить, смывать
flutter - порхать, махать крыльями/порхание
fly - муха
foam - пена
focus - сосредоточить
foe - враг
fog - туман
fold - сворачивать, складывать
folk - народ, люди
follow - следовать
follower - последователь
folly - глупость
fond - любящий, помешанный на чём-либо
food - еда
fool - дурак/дурачить
foolish - глупый
foot - ступня
for a while - пока, на время
for instance - например
for nothing - за так
for the sake of - ради, во имя
forbid - запрещать
force - вынуждать
force - сила
forcibly - сильно или насильственно
forebode - предвещать, предчуствовать
forecast - предсказывать/предсказание
forefather - предок
forehead - лоб
foreign - иностранный или внешний (о политике)
foreigner - иностранец
foremost - передний, передовой
foresee - предвидеть
foresight - предвидение, предусмотрительность
forest - лес
foretell - предсказывать
forever - навсегда
forfeit - расплачиваться/расплата
forge - ковать
forgivable - простительный
forgive - прощать
forgiveness - прощение
fork - вилка
former - бывший
former - первый (из двух)
formidable - страшный или громадный
fornication - внебрачная связь, блуд
forsake - оставлять, покидать
forth - наружу, вперёд или впредь
fortify - укреплять, поддерживать
fortunate - счастливый, удачный
fortune - удача
fortune - богатство, состояние
forward - вперёд
foster - питать, поощрять
foul - гадкий, грязный, скверный
found - закладывать, основывать
foundation - основание, фундамент
fountain - фонтан
fox - лиса
fracture - ломать/перелом
fragile - хрупкий, ломкий
frame - рамка/вставлять в рамку
frame - строение, структура, система
framework - структура, рамка
frank - искренний, честный
frantic - неистовый, безумный
fraud - обман
freak - чудной человек
free - бесплатный
free - свободный/освобождать
freedom - свобода
freeze - замораживать, замерзать
frequent - часто повторяющийся
frequent - часто посещать
fresh - свежий, новый, здоровый
fret - беспокоиться, мучиться/раздражение, мучение
friendly - дружеский, дружелюбный
friendship - дружба
fright - испуг
frighten - пугать
frightful - ужасный, противный
frivolous - пустой, легкомысленный
frog - лягушка
front - перед/передний
frontier - граница
frost - мороз
frown - хмуриться
fruit - плод, фрукт
frustrate - расстраивать
frustration - расстройство, разочарование
fry - жарить
fuck - трахаться
fuel - топливо
fugitive - беглец
fulfil - выполнять, осуществлять
full - полный
fun - веселье, забава
fund - запас, фонд
funeral - похороны/похоронный
funny - забавный, смешной
fur - мех, шерсть
furious - взбешенный, неистовый
furnish - обставлять комнату, квартиру
furnish - предоставлять
furniture - мебель
further - дальшейший
furthermore - кроме того, к тому же
fury - ярость
future - будущий/будущее (сущ.)
gain - прибыль, выгода, выигрыш/выигрывать, получать прибыль
gallant - храбрый
gamble - азартная игра/играть в азартные игры
game - дичь
gang - банда
gap - брешь, пробел, промежуток
garbage - мусор
garden - сад
garment - предмет одежды
gas - бензин, горючее
gas station - автозаправка
gasoline - бензин
gasp - дышать с трудом/затруднённое дыхание, удушье
gates - ворота
gather - собирать
gay - гомосексуалист
gaze - пристальный взгляд/пристально глядеть
gear - механизм, приспособление
gender - пол (м/ж)
general - общий, повсеместный, обычный
generalization - обобщение
generally - в общем, обычно
generation - поколение
generosity - великодушие или щедрость
generous - великодушный или щедрый
genius - гений
gentle - мягкий, нежный
genuine - подлинный, истинный
gesture - жест/жестикулировать
get - становиться, приобретать свойство
get away - уходить от
get down - опуститься
get in touch - вступить в контакт
get into - войти
get married - жениться или выйти замуж
get out - уйти, выбраться
get rid of - избавиться
get used - привыкать
ghastly - ужасный, неприятный
ghost - привидение
giant - великан/гиганский
gift - подарок/дарить
gift - дар, способность
gild - золотить
give birth - рожать
give up - отказываться
glacier - ледник
glad - довольный, радостный
glance - взгляд
glass - стакан или рюмка
glass - стекло
gleam - слабый свет или отблеск/мерцать, блестеть
glimpse - мелькание, проблеск/мимолётом увидеть
glitter - блестеть, сверкать/блеск, сверкание
globe - земной шар
gloom - мрак, уныние/хмуриться
glorious - славный, великолепный
glory - слава
gloss - внешний блеск, глянец
glove - перчатка
glow - жар, или свет/накаляться
glue - клей/клеить
go about - ходить туда-сюда, делать круги и т. п.
go by - проходить мимо
go mad - сходить с ума
go nuts - сходить с ума
go on - происходить или продолжаться
goal - цель
goat - козёл
god - бог, божество
goddess - богиня
gold - золото
golden - золотой (обычно перен.)
gonna - то же, что going to - намеревающийся
good deal - много
goods - товары, вещи
goose - гусь
gorgeous - великолепный, пышный
gospel - евангелие или проповедь
gossip - сплетня/сплетничать
govern - управлять, регулировать
government - правительство или управление
governor - губернатор
grab - схватить, захватить/захват
grace - изящество, приличие, любезность
graceful - изящный, приятный
gracious - добрый, милостивый, снисходительный
grade - степень, ранг, уровень
gradual - постепенный
graduate - оканчивать универ, выпускаться
grain - зерно или песчинка
grand - великий, главный, важный
grant - дарить, давать/дар
grape - виноград
grasp - хватать/хватка
grass - трава
grateful - благодарный
gratify - радовать, доставлять удовольствие
gratitude - благодарность
grave - могила
grave - серьёзный
gravity - серьёзность
graze - пасти(сь)
grease - жир, смазка/смазывать
great - большой, сильный, великий
greed - жадность
greedy - жадный
greet - приветствовать
greeting - приветствие
grief - горе
grieve - огорчать или горевать
grim - мрачный, зловещий
grin - скалиться, ухмыляться/оскал, усмешка
grind - молоть
grip - схватить
gross - простой, грубый, крупный
grow - расти, вырастать
grow up - взрослеть, расти
growl - рычать, ворчать/рычание, ворчание
grown-up - взрослый
growth - рост
grudge - недовольство, недоброжелательство
grumble - ворчать, жаловаться/ворчание
guarantee - гарантировать/гарантия
guard - охранять/охрана
guardian - опекун, попечитель
guerrilla - партизан/партизанский
guess - предположение, догадка/угадывать
guest - гость
guide - вести, направлять/проводник, руководитель
guilt - вина
guilty - виновный
gulf - бездна, пропасть или залив
gun - любое огнестрельное оружие
gunpowder - порох
guts - кишки или смелость (разг)
guy - (разг.) человек, чувак
gypsy - цыган/цыганский
habit - привычка
habitual - обычный, привычный
hack - рубить, тесать
hail - привет
hair - волосы, шерсть
haircut - стрижка
half - половина
halfway - полпути
hall - зал, большая комната, приёмная
halt - останавливаться, делать привал/остановка, привал
halve - делить пополам
hammer - молоток/вбивать, стучать молотком
hamster - хомяк
handful - горсть, пригоршня, в т. ч. в перен. смысле
handle - рукоятка/брать, обращаться с, управлять
handshake - рукопожатие
handsome - красивый (о мужчинах)
handy - удобный
hang - вешать, висеть
hang around - шататься вокруг, околачиваться
hang up - положить (повесить) трубку
hangman - палач
hangover - похмелье
happen - случаться
happiness - счастье
harass - беспокоить, тревожить, утомлять
harbor - гавань, убежище
hard - тяжёлый, сложный
hard - усердный (о работе)
hard - жёсткий, твёрдый
harden - твердеть, засыхать, черстветь
hardly - едва ли
hare - заяц
harm - вред, ущерб
harmful - вредный
harmless - безвредный
harsh - грубый, жёсткий, суровый
harvest - урожай
haste - поспешность, спешка
hasten - спешить, торопить, ускорять
hasty - поспешный или быстрый
hat - шляпа
hatchet - топорик
hateful - ненавистный или ненавидящий
hatred - ненависть
haul - тянуть, тащить, перевозить
haunt - преследовать (о мыслях, призраках и т. п.)
have fun - получать удовольствие, развлекаться
hawk - ястреб
hay - сено
hazard - риск, опасность
headline - заголовок
heal - излечивать, исцелять
health - здоровье
healthcare - здравоохранение
healthy - здоровый
heap - куча/нагромождать в кучу
heart - сердце
heartless - бессердечный, бесжалостный
heat - тепло, жара/нагревать
heaven - небеса
heavy - тяжёлый
hedge - забор
heed - внимание/обращать внимание
heel - пятка
height - высота
heir - наследник
helicopter - вертолёт
hell - ад
helmet - шлем
helpful - полезный
helpless - беспомощный
hemisphere - полушарие
hemp - конопля
hen - курица
hence - следовательно, отсюда
herald - вестник
herb - трава, растение
herd - стадо/пасти стадо
hereafter - потом, в будущем
heresy - ересь
heretic - еретик
hero - герой
hesitant - колеблющийся, нерешительный
hesitate - колебаться
hesitation - колебание, нерешительнотсь
hidden - скрытый
hide - скрывать
hideous - страшный, отвратительный
high - высокий
highway - шоссе, большая дорога
hill - холм
hinder - мешать, препятствовать
hindrance - помеха
hint - намёк/намекать
hire - нанимать
hiss - шипение, свист/шипеть, свистеть
historian - историк
historical - исторический (факт, объект и т. д.)
history - история
hit - попадать/попадание
hit - удар/ударять
hitch - привязывать, цеплять
hoard - запасать, копить/запас
hoarse - хрипой
hoax - обман, мистификация
hold - держать
hold off - удерживаться, воздерживаться
hole - дырка или нора
holiday - праздник
hollow - пустой, полый
holy - святой
homeland - родина
homeless - бездомный
homely - простой, обычный, невзрачный
honest - честный
honesty - честность
honey - мёд
honeymoon - медовый месяц
honor - честь, честность/чтить
honorable - честный, порядочный
hook - крючок
hop - прыгать/прыжок
hope - надеяться/надежда
hopeful - надеющийся
hopeless - безнадёжный
horizon - горизонт
horn - рог
horrible - страшный, отвратительный
horror - ужас или отвращение
horse - лошадь
hospital - больница
hospitality - гостеприимство
host - хозяин (по отношению к гостю)
hostage - заложник или залог
hostile - вражеский или враждебный
hostility - враждебность
hostility - военные действия
hot - горячий
hound - охотничья собака
household - домашняя работа
however - однако
howl - выть/вой
hug - обнимать/крепкое объятие
huge - огромный
human - человеческий/человек, смертный
humanity - человечество или человечность
humble - скромный
humbug - обман, притворство/обманывать
humiliate - унижать
humiliation - унижение
humility - смирение
humor - юмор
hump - горб
hundred - сто
hunger - голод/голодать
hungry - голодный
hunt - охотиться/охота
hunter - охотник
hurl - бросать/бросок
hurricane - ураган
hurry - торопливость, спешка/торопить
hurt - боль/причинять боль
husband - муж
husk - шелуха, оболочка
hustle - торопиться, суетиться
hut - хижина, барак
hype - активно рекламировать/шумная реклама
hypocrisy - лицемерие
ice - лёд
ID - документ, удостоверяющий личность
idea - понятие, представление
identical - одинаковый, тот же самый
identify - узнать, распознать
identity - личность, индивидуальность
idle - незанятый/бездельничать
idleness - праздность, лень, безделие
ignoble - низкий, постыдный
ignorance - невежество
ignorant - невежественный
ignore - игнорировать
ill - больной
illegal - незаконный
illiteracy - неграмотность
illiterate - неграмотный
illness - болезнь
illuminate - освещать, озарять
image - образ
imaginary - вымышленный, мнимый
imagination - воображение
imagine - вообразить, представить
imitate - подражать
immeasurable - безмерный, неизмеримый
immediate - немедленный
immense - громадный
immerse - погружать, окунать
immersion - погружение
imminent - надвигающийся, близкий, грозящий
immortal - бессмертный
immortality - бессмертие
immunity - невосприимчивость
immutable - неизменный
impact - влияние
impartial - беспристрастный, непредвзятый
impatient - нетерпеливый
impel - побуждать, принуждать
impend - нависать, надвигаться, угрожать
impenetrable - непроницаемый
imperceptible - незаметный, неразличимый
impersonal - безличный, безликий
implement - выполнять, осуществлять
implementation - осуществление, выполнение
imply - подразумевать, заключать в себе
importance - важность
important - важный
impose - облагать, налагать, навязывать
impossible - невозможный
impoverish - обеднять, истощать
impress - впечатлять
impression - впечатление
impressive - впечатляющий
imprison - заключать в тюрьму
improbable - невероятный, неправдоподобный
improper - неуместный, неправильный, неподходящий
improve - улучшать
improvement - улучшение
impudent - дерзкий, наглый
impulse - толчок, побуждение
in advance - заранее, авансом
in front of - спереди
in love - влюблённый
in order to - для того, чтобы
in return - взамен
in spite of - несмотря на
in vain - бесполезно, безрезультатно
inability - неспособность
inaccurate - неточный
inaction - бездействие
inactivity - безделье
inadequate - несоответствующий
inappropriate - неподходящий, неуместный
incapable - неспособный
incentive - побуждение, стимул
inch - дюйм или небольшое количество чего угодно
incident - случай, происществие, эпизод
incite - подстрекать, побуждать
incline - наклонять, склонять
include - включать в себя
income - доход (периодический)
incompatible - несовместимый
incomprehensible - необъяснимый, непостижимый
increase - увеличивать
incredible - невероятный, неправдоподобный
incredulity - недоверчивость, скептицизм
incriminate - обвинять в преступлении
incur - подвергаться, навлечь на себя
indecent - неприличный, недостойный, непорядочный
indecision - нерешительность
indeed - в самом деле
independence - независимость
independent - независимый
indicate - показывать, указывать
indication - признак, знак, симптом
indict - предъявлять обвинение
indifference - безразличие
indifferent - безразличный
indignation - негодование, возмущение
indispensable - необходимый, обязательный
indistinct - неясный, неотчётливый
indoor - в помещении
induce - убеждать, побуждать
indulge - поощрять, позволять, потворствовать
industry - промышленность
inequality - неравенство
inevitability - неизбежность
inevitable - неизбежный
infant - ребёнок
infantry - пехота
infect - заражать
infer - делать вывод
inferior - худший, стоящий ниже
inferiority - более низкое положение
infidelity - неверность
infinite - бесконечный
inflict - наносить, причинять (вред и т. п.)
influence - влияние/влиять
influential - влиятельный
inform - сообщать, доносить
ingenious - искусный, остроумный, изобретательный
ingratitude - неблагодарность
inhabit - жить, обитать
inherent - присущий
inherit - наследовать
inheritance - наследство, наследие
inhuman - бесчеловечный
initial - начальный
initiate - положить начало
initiative - инициатива
injunction - предписание
injure - оскорбить или ранить
injury - вред, повреждение
injustice - несправедливость
ink - чернила
in-law - родственник супруга
inmate - заключённый или обитатель
inn - гостиница
inner - внутренний
innocence - невиновность
innocent - невиновный
innumerable - бесчисленный
inquest - дознание, следствие
inquire - узнавать, спрашивать
inquiry - вопрос, запрос или исследование
insane - безумный
insanity - безумие
inscription - надпись
insect - насекомое
insert - вставлять
inside - внутри
insider - человек, владеющий эксклюзивной информацией
insight - интуиция, понимание
insignificant - незначительный
insincere - неискренний
insipid - безвкусный
insist - настаивать
insonmia - бессоница
inspiration - вдохновение
inspire - вдохновлять, внушать чувство
install - устанавливать
instant - мгновение/немедленный
instead - вместо
institution - нечто установленное - обычай, правило, система
instruct - учить или давать указания
instruction - наставление, обучение
insufficient - недостаточный
insult - оскорблять/оскорбление, обида
insurance - страхование
insure - обеспечивать, гарантировать
insurmountable - непреодолимый
intact - нетронутый, неповреждённый
integrate - составлять целое
integrity - честность, порядочность
intelligence - ум, интеллект
intelligence - разведка
intelligent - умный, понятливый
intelligible - понятный, вразумительный
intend - намереваться
intend - предназначать
intense - сильный, интенсивный
intensify - усиливать
intensity - сила, напряжённость, энергия
intent - намерение/полный решимости к чему-либо
intention - намерение
intentional - намеренный
interact - взаимодействовать
interaction - взаимодействие
intercourse - связь, отношение, взаимодейсвие
interest - интерес/заинтересовать
interfere - вмешиваться
interference - вмешательство
interior - внутренний
intermediate - средний, промежуточный
internal - внутренний
interpret - объяснять
interpretation - объяснение
interrupt - прерывать
intervention - вмешательство
intimate - близкий, личный/близкий человек
intimidate - запугивать
intimidation - запугивание
intoxicate - опъянять
intricate - запутанный, сложный
introduce - вводить, предлагать, представлять
introduction - вступление
invade - завоевать
invaluable - бесценный
invariable - неизменный
invasion - вторжение, нашествие
invent - изобретать, придумывать
invention - изобретение
inventory - товары в списке
inverse - обратный
invest - вкладывать деньги
investigate - расследовать, исследовать
investigation - расследование
investment - вложение
invincible - непобедимый
invisible - невидимый
invitation - приглашение
invite - приглашать или вызывать, провоцировать
invoke - призывать, вызывать
involve - включать в себя, предполагать, вовлекать
involvement - участие, вовлечение
inwards - вовнутрь
iron - железо/железный
irony - ирония
irrational - неразумный
irregular - неправильный
irrelevant - неуместный
irreplaceable - незаменимый
irresistible - неотразимый
irresponsible - безответственный
irreverence - неуважение
irreversible - необратимый
irritate - раздражать
island - остров
issue - вопрос, предмет обсуждения
itch - зуд/чесаться
item - предмет, пункт по списку
jacket - куртка
jail - тюрьма
jam - зажимать/сжатие
jar - банка или кувшин
jaw - челюсть
jealous - завидующий, ревнивый
jealousy - зависть или ревность
jeer - насмешка/насмехаться, глумиться
jelly - желе
jest - шутка/шутить
jet - реактивный двигатель или самолёт
jew - еврей
jewelry - ювелирные изделия
job - работа
jog - двигаться трясясь/медленная езда, ходьба, бег трусцой
join - соединять, присоединяться, вступать
joint - объединённый, совместный
joke - шутка
jolly - весёлый
journal - дневник
journalism - журналистика
journey - путешествие
joy - радость, веселье
joyful - радостный
judge - составлять мнение, судить
judge - судья/судить
judgement - суждение или рассудительность
jug - кувшин
juice - сок
jungle - джунгли
junior - младший
junk - хлам
junkie - наркоман
just - просто, всего лишь
just - только что
just - верный, точный
just - справедливый
justice - справедливость или правосудие
justify - оправдывать
keen - острый
keep away - остерегаться, избегать
keep from - удерживать от
keep on - продолжать делать
kernel - ядро, зернышко, суть
kettle - чайник или кастрюля
key - ключ
kick - пинать
kid - ребёнок
kidnap - похищать человека
kind - вид, тип
kind - добрый
kindle - зажигать (огонь)
kindness - доброта
king - король
kingdom - королевство
kiss - поцелуй
kitchen - кухня
kitten - котёнок
knack - искусство, ловкость
knee - колено
kneel - становиться на колени
knife - нож
knit - вязать
knob - ручка, кнопка и т. д. на аппарате
knock - стучать/удар
knot - узел/завязывать узел
knowledge - знание
known - известный
label - ярлык, отметка/называть, метить, вешать ярлык
labor - труд
laborious - трудолюбивый или трудоёмкий
lack - недостаток или полное отсутствие
ladder - лестница
lag - отставать
lake - озеро
lamb - ягнёнок
lame - хромой
land - земля/приземляться
landlord - владелец земли или квартиры
landmark - веха, межевой знак
landscape - пейзаж, ладшафт
lane - узкая дорога, переулок
language - язык
lantern - фонарь
lap - колени
large - широкий, обширный
lash - кнут/хлестать
last - длиться, продолжаться
last - последний
lasting - длительный, постоянный
late - поздно, поздний
lately - недавно, за последнее время
latent - скрытый, незаметный
latter - последний (из перечисленного)
laugh - смеяться
laughter - смех
launch - начинать, пускать в ход
lavatory - туалет
lavish - щедрый, расточительный
law - закон
lawful - законный
lawsuit - судебный процесс
lawyer - юрист или адвокат
lay - класть, положить
layer - слой
lazy - ленивый
lead - вести
leadership - лидерство
leaf - лист
leak - течь, протекать/утечка
lean - худой
lean against - облокотиться
leap - прыгать/прыжок
learn - узнавать или изучать
lease - аренда/сдавать или брать в аренду
least - маленький/наименее
least - как минимум
leather - кожа (материал)
leave - оставлять, уезжать, покидать
leave alone - оставлять в покое
leave behind - оставить позади или обогнать
leftovers - остатки
leg - нога
legacy - наследство, наследие
legal - законный
legislation - законодательство
legislator - законодатель
leisure - досуг
lend - давать в долг
length - длина
less - меньше, в меньшей степени
lessen - уменьшать
lesser - меньший
lesson - урок
lest - чтобы не
let alone - не говоря о
let go - отпустить
letter - письмо
letter - буква
level - уровень/уравнивать, сглаживать
lever - рычаг
liability - подверженность, обязанность
liable - обязанный, подверженный
liar - лжец
liberate - освобождать
liberation - освобождение
liberty - свобода
library - библиотека
license - разрешение, лицензия
lick - лизать
lid - крышка
lie - ложь/лгать
lie - лежать, располагаться
lifetime - продолжительность жизни
lift - поднимать
light - свет, освещение/освещать, зажигать
light - лёгкий
lightning - молния
likely - вероятный/вероятно
likewise - подобно
limb - конечность
limit - предел
limitation - ограничение
limp - хромота/хромой
line - очередь, ряд людей
line - линия или строка
linger - медлить, тянуть
link - соединять, связывать/звено
lion - лев
lip - губа
lipstick - губная помада
liquid - жидкий, водяной, прозрачный, плавный
list - список/вносить в список
literally - буквально
literate - грамотный
live - живой
liver - печень
living room - гостиная, зал, общая комната
lizard - ящерица
load - заряжать
load - грузить/груз
loaf - буханка, булка
loan - давать в долг/заём
loathe - ненавидеть
local - местный
locate - определять местонахождение или располагать
location - местоположение
lock - замок/запирать
lock up - сажать в тюрьму или дурдом
lodge - давать помещение или временно проживать
lofty - высокий, возвышенный
log - бревно
loneliness - одиночество
lonely - одинокий или безлюдный
lonesome - одинокий
long ago - давно
long for - страстно желать, стремиться
look for - искать
look like - быть похожим
loop - петля
loophole - лазейка, уловка
loose - свободный, ненатянутый, просторный
loot - грабить/добыча
lord - господин или Господь (Бог)
lose - терять
lose - проигрывать
loser - проигравший или неудачник
loss - потеря
lot - участь, доля, судьба
lottery - лотерея
loud - громкий
lounge - лениво ходить или валяться/праздное времяпрепровождение
lousy - паршивый, поганый
lovely - привлекательный, милый
lover - возлюбленный, любовник
low - низкий
lower - нижний/снижать
lowly - скромный, непритязательный
loyal - преданный
loyalty - верность
luck - удача
lucky - удачный, везучий
lucrative - прибыльный
luggage - багаж
lull - успокаивать, убаюкивать
lumber - ненужный хлам/загромождать
lunar - лунный
lunch - обед
lung - лёгкое
lure - соблазн, привлекательность/завлекать, соблазнять
lurk - скрываться, прятаться
lust - похоть, вожделение
luxury - роскошь или наслаждение
lyrics - стихи
machinery - оборудование
mad - безумный
madden - сводить с ума, бесить
madhouse - сумасшедший дом
madness - безумие
magazine - журнал
magic - магический/волшебство
magnificent - великолепный
maiden - девица, девушка
mail - почта
mainly - в основном
maintain - поддерживать
maintenance - сохранение, поддержание
majesty - величие или величество
major - большой, главный, старший
majority - большинство
make clear - прояснить
make fun - смеяться над чем-то
make sure - убедиться
make up - выдумать
makeup - макияж, грим
male - мужчина или самец/мужской
malice - злоба или злой умысел
malicious - злобный, злонамеренный
manage - управлять
manage to - справиться с задачей
management - управление
manhood - зрелый возраст
manifest - очевидный
mankind - человечество
manner - способ, образ действия
mansion - большой дом, дворец
manual - инструкция
many - многие/много
map - карта
marble - мрамор
margin - край
margin - наценка
marginal - крайний, пограничный
marijuana - марихуана
mariner - моряк
mark - знак/помечать
market - рынок/рыночный
marriage - замужество, женитьба
marry - жениться или выходить замуж
marshal - выстраивать, располагать в порядке
martial - военный
martyr - мученик, страдалец
marvel - чудо, диво/удивлять
marvellous - изумительный
mask - маскировать, скрывать/маска, личина
masquerade - притворяться
massacre - резня, бойня/устраивать бойню
massive - крупный, огромный
master - овладевать (умением, инструментом и т. п.)
master - хозяин
masterpiece - шедевр
mastery - мастерство
match - спичка
match - ровня, пара, что-то подходящее/подходить
mate - товарищ по чему-либо
math - математика
matter - иметь значение
matter - вопрос, предмет, содержание, дело, сущность
mature - зрелый/созреть
maturity - зрелость, завершённость
mayor - мэр
meadow - луг
meal - пища
mean - означать, значить, иметь в виду
mean - средство
mean - предназначать для чего-то
meaning - значение
meaningful - значительный
meaningless - бессмысленный
meantime - тем временем
meanwhile - тем временем
measure - мера/измерять
meat - мясо
meddle - вмешиваться
mediator - посредник
medicine - лекарство
mediocre - посредственный
meditate - размышлять
medium - средство
meet - встречать или знакомиться
meeting - встреча, совещание
melancholy - уныние
melon - дыня
melt - таять или плавить
member - член
memorial - памятник
memory - память
menace - угроза/угрожать
mend - чинить
mental - умственный
mention - упоминать/упоминание
merchant - торговец
merciful - милосердный, сострадательный
mercy - милосердие или милость
mere - простой, явный
merely - всего лишь
merge - сливаться, соединяться
merit - заслуга/заслуживать
merriment - веселье, развлечение
merry - весёлый, радостный
mess - беспорядок/производить беспорядок
message - послание, сообщение
midday - полдень
middle - середина/средний
midnight - полночь
midst - середина
midway - полпути
might - могущество, сила
mighty - могущественный
mild - мягкий, умеренный
mile - миля
military - военный
milk - молоко
mill - мельница
mind - разум/знать, помнить
mind - возражать
mindful - помнящий
mine - шахта, рудник
mingle - смешивать
minor - незначительный, второстепенный, меньший
minority - меньшинство
miracle - чудо
mirror - зеркало
mirth - веселье
mischief - беда, зло, повреждение
misconduct - плохо вести себя/дурное поведение
miser - скупой человек
miserable - жалкий, несчастный
misery - страдание, беда, невзгоды
misfortune - неудача, несчастье
misgovernment - плохое управление
mislead - вводить в заблуждение, сбивать с пути
mismanagement - плохое управление
miss - упустить, пропустить, не попасть
miss - скучать
missile - ракета
mist - туман
mistake - принимать за
mistake - ошибка
mistress - госпожа
mistrust - не доверять
misunderstand - не понимать
misunderstanding - недоразумение
misuse - неправильно использовать
mix - смешивать
mixture - смесь или примесь
mob - толпа
mock - насмехаться/осмеяние
mockery - насмешка
mode - способ, образ действия
moderate - умеренны
moderation - умеренность
modern - современный
modest - скромный
modesty - скромность
modify - видоизменять
mold - формировать, создавать
mom - мама
monetary - денежный или валютный
monk - монах
monkey - обезьяна (небольшая)
monotonous - однообразный
monster - чудовище
monstrous - чудовищный
month - месяц
monthly - ежемесячный/ежемесячно
monument - памятник
mood - настроение, расположение духа
moon - луна
moon - луна
moron - дурак
mortal - смертный или смертельный
mortgage - ипотека
mortify - унижать, подавлять или умерщвлять
mosque - мечеть
mosquito - комар
most - наибольший/больше всего
mostly - по большей части
motion - движение
motionless - неподвижный
motive - стимул, побуждение
mount - взбираться
mountain - гора
mourn - сетовать, оплакивать
mouse - мышь
mouth - рот
move - двигать, шевелить
movement - движение
movie - кино
mud - грязь
multiple - составной или многочисленный
multiplication - умножение
multiply - увеличиваться или размножаться
multitude - множество
mumble - бормотать/бормотание
murder - убийство/убивать
muscle - мышца
museum - музей
mushroom - гриб
musician - музыкант
muslim - мусульманин
mustache - усы
mustard - горчица
muster - собирать
mute - молчаливый или немой
mutual - обоюдный, взаимный
mysterious - таинственный, непостижимый
mystery - тайна
nail - гвоздь
naked - обнажённый
nap - дремота, сон/дремать
narrow - узкий
nasty - гадкий, отвратительный
native - родной
natural - естественный
nature - природа
naval - военно-морской
navy - военно-морской флот
nazi - нацист
nearby - неподалёку
nearly - почти
neat - аккуратный, изящный
necessary - необходимый
necessity - необходимость
neck - шея
need - нуждаться/потребность
needle - игла
needless - ненужный
negate - отрицать
neglect - пренебрежение/пренебрегать
negotiate - вести переговоры
negotiation - переговоры
neighbor - сосед
neighborhood - соседство, окрестность
neither - ни
neither - ни один ни другой
nephew - племянник
nerve - нервы или смелость
nervous - нервный
nest - гнездо
net - сеть
network - сеть
neutral - нейтральный
nevertheless - несмотря, однако
news - новости
newspaper - газета
next door - по соседству
nibble - обгрызать, откусывать
nice - хороший, приятный
nickname - прозвище
niece - племянница
nightmare - кошмар
no matter - неважно
nobility - благородство
noble - благородный
nod - кивать
noise - шум
noisy - шумный
none - никто, никакой, ни один
nonetheless - однако
nonsense - бред, чушь
noon - полдень, середина дня
nor - ни
normality - нормальность
north - север
northern - северный
nose - нос
nostril - ноздря
note - замечание, заметка, знак
nothingness - ничто, небытие
notice - замечать/наблюдение
notion - понятие, представление
notorious - пользующийся дурной славой
noun - имя существительное
nourish - питать, кормить
novel - роман
novelty - новизна
nowadays - в наше время
nowhere - нигде
nuclear - ядерный
nudity - нагота
nuisance - неприятность, помеха, неудобство
numb - онемелый, окоченелый
number - количество
numerous - многочисленный
nurse - медсестра или нянька
nurture - воспитывать, питать
nut - орех
nut - придурок
nutrition - питание
oak - дуб
oath - клятва
obedience - покорность
obey - подчиняться
object - возражать
object - предмет
objection - возражение
objective - цель
obligation - обязательство
oblige - обязывать
obscene - неприличный, непристойный
obscure - неясный, туманный/затуманивать, затемнять
observe - наблюдать
obsess - овладеть, обуять
obsession - одержимость, навязчиватя идея
obsolete - устаревший
obstacle - препятствие
obstinacy - упрямство
obstinate - упрямый
obstruct - преграждать, заслонять
obtain - получать, достигать
obvious - очевидный
occasion - случай, возможность
occasional - случайный, редкий
occupation - занятие
occupy - занимать
occur - случаться, происходить
occur - приходить на ум
occurence - случай, происшествие
ocean - океан
odd - странный
odor - запах, аромат
offence - обида
offence - нарушение, проступок
offend - обижать
offend - нарушить, погрешить против ч-л
offensive - оскорбительный
offer - предлагать/предложение
officer - чиновник, служащий
official - должностное лицо
often - часто
oil - масло
oil - нефть
old age - старость
omen - предзнаменование, примета
ominous - зловещий
omit - пропускать, опускать
on the alert - начеку
on the contrary - наоборот
once - однажды
one and a half - полтора
onion - лук, луковица
opening - отверстие
operate - управлять, действовать
opinion - мнение
opportunity - возможность
oppose - противостоять
opposite - противоположный
opposition - противостояние
oppression - притеснение, угнетение
option - выбор, предмет выбора
optional - необязательный
order - порядок/приводить в порядок
order - приказывать/приказ
orderly - аккуратный, организованный
ordinary - обычный
ore - руда
origin - происхождение, истоки
original - изначальный
originate - происходить, брать начало
orphan - сирота
otherwise - иначе, иным образом
ought - должен
out there - где-то там
outbreak - взрыв, вспышка, внезапное начало
outcome - результат
outdated - устаревший
outdo - превзойти
outdoor - вне дома
outer - внешний
outlet - выход, сток, отдушина
outline - очертания
outlook - кругозор, точка зрения
outnumber - численно превосходить
output - выпуск, выход продукции
outrage - возмутительный поступок, грубое нарушение
outrageous - возмутительный
outright - прямой, открытый
outrun - обогнать, превзойти
outset - отправление, начало
outside - снаружи
outsider - посторонний
outstanding - выдающийся
outward - внешний, наружний
oven - печка, духовка
overcome - победить, преодолеть
overestimate - переоценивать
overflow - переливаться через край/выплеск, избыток
overhead - наверху
overlook - не замечать
overly - чрезмерно
overnight - за ночь или очень быстро
overseas - заморский/за морем
oversee - надзирать, наблюдать
overshadow - затмевать
oversight - недосмотр
overtake - догнать
overthrow - опрокидываться
overtime - сверхурочное время
overturn - перевернуть
overweight - излишек веса/весящий сверх нормы
overwhelm - заваливать, забрасывать, подавлять
overwork - чрезмерная работа, перенапряжение
owe - быть должным, быть обязанным
owing to - благодаря, вследствие
own - владеть/собственный
owner - собственник
ox - бык
oxygen - кислород
pace - шаг/шагать
pack - множество, куча, пачка/упаковывать
package - упаковка/упаковывать
pad - мягкая подкладка/подшивать, утеплять
paddle - грести
pagan - язычник/языческий
page - страница
pain - боль
painful - болезненный, неприятный
pains - старание, усилия
paint - краска/красить
painting - картина
pair - пара
palace - дворец
pale - бледный, слабый, тусклый
pall - надоедать
palm - ладонь
pan - сковорода
pants - штаны
paper - бумага в т. ч. документ
paradise - рай
parcel - пакет, посылка
pardon - прощение/прощать
part - часть/разделять
partial - частичный
participant - участник
participate - участвовать
participation - участие
particle - частица
particular - частный, конкретный
partly - частично
party - вечеринка
party - сторона (в процессе)
pass - проходить
pass - проводить, переносить
pass for - сойти за что-либо
passage - ход, прохождение
passenger - пассажир
passion - страсть
passionate - страстный
password - пароль
past - прошлое/прошедший
past - мимо
pastime - времяпрепровождение
pasture - пастбище
pat - хлопок, шлепок/похлопывать
patch - пятно, участок, лоскут, заплатка
patch - грядка
path - путь
pathetic - жалкий
patience - терпение
patient - терпеливый
pattern - шаблон, модель, узор
paunchy - толстый, с брюшком
pause - делать перерыв/пауза
pave - мостить
pavement - тротуар
paw - лапа
pay - платить
pay - делать, оказывать (напр. внимание)
payment - платёж
payoff - выплата, платёж
peace - мир, покой
peaceful - мирный, спокойный, тихий
peak - вершина, высшая точка
pear - груша
peasant - крестьянин
peculiar - определённый, специфический
pedestrian - пешеход
peep - подглядывать
peer - вглядываться
pen - перо или ручка
penalty - наказание
pencil - карандаш
penetrate - проникать
penny - одноцентовая монета
people - народ, нация, люди
perceive - воспринимать, ощущать
percent - процент
perception - восприятие
perfect - совершенный
perform - выполнять, совершать
performance - исполнение, игра, спектакль
performance - исполнение, совершение, действие
perhaps - возможно
peril - опасность, риск
perish - погибать
permanent - постоянный
permission - разрешение, позволение
permit - позволять, давать возможность
perpetual - вечный
perplex - запутывать, смущать
persist - упорствовать
persistence - упорство
persistent - упорный, настойчивый
person - человек
personal - личный
personality - личность, индивидуальность
personnel - персонал
persuade - убеждать
persuasion - убеждение
persuasive - убедительный
perversity - извращение
pervert - извращенец/извращать или совращать
petal - лепесток
petty - мелкий, незначительный
phase - стадия, период, этап
phone - телефон
phony - обман, подделка, жулик, обманщик
physician - врач
physics - физика
piano - фортепьяно
pick - выбирать
pick up - поднять, подобрать, забрать
picture - картина
pie - пирог
piece - кусок, часть
piece - отдельный предмет, штука
pierce - протыкать
pig - свинья
pigeon - голубь
pile - куча, груда/складывать в кучу
pill - таблетка
pillar - столб
pillow - подушка
pilot - лётчик или лоцман
pin - булавка
pinch - щипать, сдавливать
pine - сосна
pipe - свисток
pipe - курительная трубка
piss - пИсать
piss off - бесить
pit - яма
pitch - ставить, устанавливать
pity - жалость/жалеть
place - место
plague - бедствие/насылать бедствие
plain - ясный, прямой, понятный
plane - самолёт
plant - куст /сажать растение
plaster - штукатурка/штукатурить, оклеивать, покрывать
plate - тарелка
platform - трибуна
plausible - правдоподобный, благовидный
plea - просьба, призыв
plead - обращаться, просить, умолять
pleasant - приятный
please - нравиться или угождать
pleasure - удовольствие
pledge - обещание, поручительтво, залог/давать обещание, ручаться
plentiful - обильный
plenty - множество, избыток
plot - план или сюжет
plot - грядка
plow - плуг/пахать
pluck - смелость
plug in - включать (прибор)
plumber - водопроводчик
plumbing - водопровод
plunge - нырять, окунаться, бросаться/ныряние, погружение
pocket - карман/класть в карман
poetry - поэзия
point - цель, дело, вопрос
point - кончик
point - точка
point out - указывать
pointless - бессмысленный, бесцельный
poise - равновесие/держать равновесие
poison - яд/отравлять
poke - совать, пихать, толкать/толчок
policy - политика
polish - полировать, чистить
polite - вежливый
politeness - вежливость
politician - политик
poll - опрос
pollution - загрязнение
pond - пруд
ponder - обдумывать, взвешивать
pool - лужа, прудок, заводь
poor - бедный
poor - плохой, скверный, убогий
pop - хлопать, щёлкать
pope - папа римский
populate - населять
population - население
porch - крыльцо
pork - свинина
portable - портативный, переносной
portal - ворота, портал
portrait - портрет
pose - принимать позу, ставить, располагать
position - положение
positively - безусловно, несомненно
possess - владеть
possession - владение, собственность
possibility - возможность, вероятность
possible - возможный
post - почта
postal - почтовый
postpone - откладывать
posture - поза, положение
pot - горшок, котелок
potato - картошка
potency - сила, могущество
potent - могущественный
potential - способность, возможность
pound - фунт
pour - лить
poverty - бедность
powder - порошок, порох, пыль
power - сила или власть
powerful - сильный, могущественный
praise - хвалить/хвала
pray - молиться
prayer - молитва
preach - проповедовать, поучать
precaution - предосторожность или предостережение
precautionary - предупредительный
precede - предшествовать
precious - драгоценный
precise - точный, аккуратный, чёткий
precision - точность
predatory - хищный
predecessor - предшественник или предок
predict - предсказывать
predictable - предсказуемый
prediction - предсказание
predominant - преобладающий
predominate - преобладать
prefer - предпочитать
preference - предпочтение
pregnancy - беременность
pregnant - беременный
prejudice - предубеждение, предрассудок/создавать предубеждение
preliminary - предварительный
premature - преждевременный
premises - помещения, система построек
preoccupied - занятый, поглощённый
preparation - приготовление
prepare - подготовить, готовиться
prescribe - предписывать
prescription - предписание
presence - присутствие
present - присутствующий, настоящий/настоящее время
present - подарок/дарить подарок
presentation - предоставление, показ
presently - скоро
preservation - сохранение
preserve - сохранять
press - давить, нажимать
pressure - давление, воздействие, напряжённость
presumably - предположительно
presume - предполагать
pretend - притворяться
pretense - претензия, притворство
pretty - весьма, достаточно
pretty - приятный, симпатичный
prevail - преобладать, брать верх
prevent - предотвращать
prevention - предотвращение
previous - предыдущий
prey - добыча
price - цена
prick - уколоть/укол
pride - гордость
priest - жрец, священник
primary - первостепенный, первичный, основной
principal - основной
principle - принцип
print - печатать/печать, шрифт
prior - предшествующий или более важный, первейший
prison - тюрьма
prisoner - узник, пленник
privacy - секретность, уединённость
private - личный
prize - премия, приз
probability - вероятность или правдоподобие
probably - вероятно
probe - исследовать/расследование
proceed - действовать, происходить, приступать, продолжать
proclaim - провозглашать, объявлять
proclamation - объявление, заявление
procrastination - откладывание, промедление
procure - достигать, добывать
produce - производить, создавать, вырабатывать/продукция
production - производство или продукция
profanity - богохульство
profess - открыто признавать, показывать, притворяться
proficient - искусный, умелый
profit - польза/приносить пользу
profitable - полезный
profound - глубокий, полный, основательный
profuse - изобильный, богатый, расточительный
progress - продвигаться вперёд/продвижение, улучшение
prohibit - запрещать, препятствовать
prohibition - запрещение
prolong - продлевать или продолжать
prominent - выдающийся, выступающий, в т. ч. в перен. смысле
promise - обещание/обещать
promote - продвигать, поощрять, способствовать
promotion - продвижение чего-либо
prompt - проворный, быстрый
prompt - побуждать, толкать
prone - склонный к чему-либо
pronounce - произносить
proof - доказательство
prop - подпорка/подпирать
propel - продвигать вперёд, толкать, стимулировать
proper - соотвествующий
property - имущество
prophecy - предсказание
prophesy - пророчить, предсказывать
prophet - пророк
proposal - предложение
propose - предлагать или предполагать
proposition - предложение или заявление
propriety - правильность, уместность
prosecute - преследовать
prosecution - преследование цели, выполнение работы
prospect - перспектива, планы на будущее
prospective - будущий, предполагаемый
prosper - процветать
prosperity - процветание
prosperous - процветающий
protect - защищать
protection - защита
protective - защитный
proud - гордый, гордящийся
prove - доказывать
proverb - пословица
provide - обеспечивать, предоставлять
provide - при условии, что
providence - провидение
provision - снабжение, обеспечение, приспособление
provoke - вызывать, провоцировать
prudent - благоразумный, предусмотрительный
public - общественный
publicity - публичность, гласность, реклама
publish - опубликовать
puke - блевать
pull - тянуть
pull down - сносить (здание)
pull off - добиться, справиться
pull up - остановиться
punch - ударить кулаком/удар кулаком
punish - наказать
punishment - наказание
pupil - ученик, школьник
puppy - щенок
purchase - покупать/покупка
pure - чистый, безупречный, простой
purify - очищать
purple - пурпур/пурпурный цвет
purpose - цель
purse - кошелёк
pursue - преследовать, гнаться
pursuit - погоня, преследование
push - толкать, нажимать
put back - вернуть
put off - откладывать
put on - одеть
put together - соединить
put up - возводить (сооружение)
put up - мириться, привыкать
puzzle - вопрос, головоломка/запутывать
quaint - приятно необычный, причудливый
quake - дрожание/дрожать
qualified - компетентный
quality - качество, свойство
quantity - количество
quarrel - ссора/ссориться
quarry - добыча
quarter - четверть
queen - королева
queer - странный
quest - поиски
question - спрашивать/вопрос
question mark - вопросительный знак
questionable - сомнительный
queue - очередь
quick - быстрый
quickness - быстрота
quiet - тихий, молчаливый
quit - прекратить
quit - уволиться
quite - вполне, совершенно
quotation - цитата, цитирование
quote - цитировать/цитата
rabbit - кролик
race - гонки, скачки/состязаться в скорости
race - племя, народ, раса
racial - расовый
rack - стойка, подставка, вешалка
rag - тряпка
rage - ярость, гнев/бушевать, гневаться
ragged - неровный, шероховатый
raid - набег, нападение, облава
rail - рельс или перила
railroad - железная дорога
railway - железная дорога
rain - дождь
rainbow - радуга
raise - поднимать
raise - выращивать, воспитывать (детей, животных)
rally - объединять, собирать
ram - баран
random - случайный
range - сфера, область, предел, ареал
rank - располагать в порядке убывания, ранжировать
rank - ряд
rape - насиловать/изнасилование
rapid - быстрый, скорый
rare - редкий
rascal - мошенник, плут
rash - стремительный, поспешный, неосторожный, опрометчивый
rat - крыса
rate - норма, уровень, тариф, ставка
rather - скорее, предпочтительнее, вернее
ratio - отношение, пропорция
rational - разумный
rattle - греметь
ravage - разорять, опустошать/разорение
raw - сырой, необработанный
ray - луч
razor - бритва
reach - достигать, дотягиваться/предел досягаемости
react - реагировать, отзываться
ready - готовый/подготавливать
real - настоящий
real estate - недвижимость
realistic - практический
reality - реальность
realize - понимать, осознавать
really - в самом деле
realm - королевство
reap - жать, пожинать плоды
rear - задний
rearrange - переделывать, переставлять, преобразовывать
reason - причина, повод
reason - разум/рассуждать, обсуждать, убеждать
reasonable - разумный
reassure - заверять, убеждать
rebel - бунтовать/повстанец
rebellion - восстание
rebound - отскакивать/отскок
recall - вспоминать или напоминать
recall - возвращать назад
recapture - вернуть
recede - отступать, удаляться
receipt - расписка в получении, квитанция
receive - получать
recently - недавно, на днях
reception - принятие, получение
recess - укромное место, углубление, уголок
recession - спад, снижение
recipe - рецепт, средство
recipient - получатель
recite - рассказывать, излагать
reckless - безрассудный, дерзкий
reckon - считать за, полагать
reclaim - вернуть утраченное обратно или требовать вернуть
recognition - принятие
recognize - признавать, распознавать
recollect - вспоминать
recollection - воспоминание
recommend - советовать
reconcile - мирить(ся)
reconciliation - премирение
record - запись/записывать
recount - рассказывать, излагать
recover - вернуть, получить вновь
recover - выздаравливать, восстанавливаться
recovery - восстановление, возмещение
rectify - исправлять
recycle - перерабатывать вновь, повторно использовать
redeem - возмещать, искупать
redouble - усиливать, наращивать
reduce - понижать, сводить, приводить к
reduction - снижение
redundant - излишний
refer - передавать на рассмотрение
refer - говорить, упоминать, ссылаться
reference - ссылка, упоминание
refine - очищать, улучшать
reflect - размышлять, раздумывать
reflect - отражать, отражаться
reflection - отражение
reflection - размышление
refrain - воздерживаться
refresh - освежать
refuge - убежище
refund - уплата, возвращение денег/возвращать
refusal - отказ
refuse - отказываться
refute - опровергать
regain - получить вновь
regard - рассматривать, считать кем-то
regard - внимание, уважение/принимать во внимание
regenerate - возраждаться, восстанавливаться
regret - сожаление/сожалеть
regular - постоянный, обычный, правильный
rehearsal - репетиция
rehearse - репетировать
reign - царствовать
reinforce - усиливать, подкреплять
reject - отвергать
rejection - отказ, отклонение
rejoice - радовать(ся)
rejoin - присоединиться, примкнуть
relate - иметь отношение
relation - отношение, связь
relationship - отношения, взаимоотношения
relative - родственник
relative - относительный, сравнительный
relax - расслаблять(ся), ослаблять
relaxation - ослабление, расслабление
relay - передавать
release - освобождать, отпускать/освобождение
relevant - уместный, относящийся к делу
reliability - надёжность
reliable - надёжный
reliance - доверие, уверенность
relief - облегчение
relieve - облегчать, успокаивать
relish - удовольствие/получать удовольствие
reluctance - неохота, нежелание
reluctant - неохотный
rely - полагаться
remain - оставаться, сохранять
remainder - остаток
remark - замечание/делать замечание
remarkable - замечательный, выдающийся
remedy - средство
remembrance - воспоминание
remind - напоминать
reminder - напоминание
reminiscence - воспоминание
remorse - угрызение совести, сожаление
remote - удалённый/пульт от телевизора
removal - удаление
remove - удалять
render - переводить в какое-либо состояние
renew - обновлять
renewal - обновление
renown - слава, известность
rent out - сдавать в аренду
repair - восстанавливать/восстановление
repay - отдавать, оплачивать
repeal - отменить, аннулировать
repeat - повторять
repel - отвергать, оклонять, отталкивать
replace - заменять
replacement - замена
reply - отвечать/ответ
report - отчёт, сообщение, слух
repose - отдыхать, лежать/отдых, покой
represent - представлять
representative - представитель/представляющий
repress - подавлять, сдерживать
repression - подавление
reproach - упрекать/упрёк
reprove - порицать
repudiate - отказываться, отрекаться, отвергать
repulsive - отталкивающий
repute - общее мнение, репутация/считать, полагать
request - просьба, запрос/просить
require - требовать
requirement - требование, необходимое условие
rescue - спасать/спасение, избавление
research - исследование/исследовать
resemblance - сходство
resemble - походить, иметь сходство
resent - негодовать, возмущаться
resentment - негодование, возмущение
reserve - сберегать, сохранять, откладывать/запас
reservoir - хранилище
reside - находиться, пребывать
resign - отказываться, отдавать
resignation - покорность, смирение
resist - сопротивляться
resistance - сопротивление
resolute - решительный
resolution - решительность, решение
resolve - решить/решение, намерение
resort - прибежище/прибегать к чему-либо
resource - средство, возможность, ресурс
respect - уважать/уважение
respectful - уважительный
respite - передышка, отсрочка
respond - отвечать, реагировать
response - ответ
responsibility - ответственность
responsible - ответственный
rest - отдых/покоиться
rest - остаток/оставаться/остальные
restoration - восстановление, возвращение
restore - восстанавливать, возрождать
restrain - сдерживать, ограничивать
restraint - ограничение
restrict - ограничивать
restriction - ограничение
result - результат/следовать, иметь итогом
resume - возобновлять или получать обратно
resumption - возобновление
resurrect - воскресать
resurrection - воскрешение
retail - розничная торговля
retain - удерживать, сохранять
retire - удаляться или оставлять должность
retirement - отставка, пенсия
retort - возражение, остроумная реплика
retract - отказываться (от слов), отрекаться
retreat - оступать/отступление
retrospect - взгляд в прошлое
return - возвращать/возвращение
reuse - повторно использовать
reveal - открывать, показывать
revelation - открытие, открывание
revenge - месть/мстить
revengeful - мстительный
revere - уважать, почитать
reverence - почтение, почтительность
reverie - задумчивость, мечтательность, мечты
reverse - обратный, противоположный/переворачивать, обращать
review - обзор, обозрение/обозревать
revile - оскорблять, ругать
revise - проверять, исправлять
revival - возрождение, оживление, восстановление
revive - оживлять, приводить в чувство
revolt - восстание, мятеж/бунтовать
reward - награда, вознаграждение
rib - ребро
rice - рис
rich - богатый
riches - богатства
riddle - загадка
ride - ездить верхом
ridicule - осменяние
ridiculous - смехотворный
rifle - винтовка
right - правильный
right - право
right away - сразу, мнгновенно
rightful - законный, справедливый
rigid - жёсткий, неподвижный
rim - ободок, край
ring - кольцо
ring - звонок/звенеть
riot - бунт
rip - рвать, разрезать/разрыв
ripe - спелый, готовый
ripen - зреть
ripple - рябь, зыбь
rise - поднимать, повышать/поднятие, повышение
risk - рисковать/риск
ritual - обряд, ритуал
rival - соперник, конкурент
rivalry - соперничество, конкуренция
river - река, поток
road - дорога
roam - бродить, скитаться/скитание
roar - рёв, шум/реветь
roast - жарить/жаркое
rob - грабить, обкрадывать
robbery - ограбление
robe - мантия, халат, одеяние
robust - крепкий, здоровый
rock - качать
rock - скала
rod - прут, палка, удочка
rogue - жулик
roll - катиться, вертеться, сворачиваться/свёрток, рулон
romance - роман
roof - крыша
room - пространство
room - комната
roommate - сосед по комнате
root - корень
rope - верёвка
rot - гнить/гниение
rotten - гнилой
rough - грубый
roughly - приблизительно
round - круг/круглый/вокруг
roundly - энергично, основательно
rouse - будить, побуждать, поднимать
route - маршрут/направлять по маршруту
routine - заведённый порядок
row - ряд
royal - королевский
rub - тереть
rubber - резина
rubbish - мусор
rude - грубый
rug - коврик или плед
ruin - погубить, разрушить/гибель
rule - правило/управлять
rumor - слух
run for - участвовать в выборах
runaway - беглец/беглый
rural - сельский, деревенский
rush - торопиться, мчаться
rust - ржавчина/ржаветь
rut - колея, борозда
ruthless - жестокий, бесжалостный
sack - мешок
sacred - священный
sacrifice - жертва/жертвовать
sad - грустный
safe - безопасный
safety - безопасность
sail - парус/плыть под парусом
saint - святой
salary - зарплата
sale - продажа или распродажа
salesperson - продавец
salt - соль/солить
salvage - спасение/спасать
salvation - спасение
sample - образец, шаблон
sanction - одобрение, разрешение
sand - песок
sane - находящийся в своём уме
sanity - психическое здоровье
satellite - спутник
satisfaction - удовлетворение
satisfactory - удовлетворительный
satisfy - удовлетворять
saucer - блюдце
sausage - колбаса
savage - дикий/дикарь
save - экономить
save - спасать
save - кроме
savings - сбережения
saying - высказывание, поговорка
scale - уровень, ступень
scales - весы
scant - скудный
scarce - недостаточный, скудный
scarcely - едва
scare - пугать/испуг, паника
scary - пугающий
scatter - разбрасывать
scent - запах/чуять или нюхать
schedule - расписание, график/составлять расписание
scheme - схема, план, график
scholar - учёный
science - наука
scientific - научный
scientist - учёный
scissors - ножницы
scold - бранить, ругать
scope - границы, рамки, пределы
score - счёт (по игре и т. п.)
scorn - презрение, насмешка
scornful - презрительный
scramble - продираться, карабкаться
scrambled eggs - яичница
scrap - клочок, кусок, остаток
scrape - скоблить, скрести
scratch - царапина/царапать, скрести
scream - вопль, крик/кричать
screen - экран
screw - трахать, совокупляться
screw - прикручивать, завинчивать
screw up - испортить
scripture - писание
scroll - прокручивать (текст на компе)
scrub - тереть, скрести
scrutinize - исследовать, рассматривать
scrutiny - внимательный осмотр
scum - пена, накипь, отбросы
sea - море
seal - печать/опечатывать
search - поиски/искать, исследовать
season - пора, время, период
season - приправлять, или придавать интерес
seat - место, сиденье
secondary - вторичный, второстепенный, побочный
secrecy - секретность
secret - тайна
section - отдел, отделение
secular - мирской, светский
secure - безопасный, спокойный/обезопасить, сохранить
security - безопасность
seduce - соблазнять
seduction - обольщение, соблазн
seed - семя/сеять, сажать растения
seek - добиваться, стремиться
seek - искать
seek after - добиваться, стремиться
seem - выглядеть
seemingly - видимо
seize - хватать, ухватываться
seldom - редко
select - выбирать
selection - выбор, набор, подбор
selective - избирательный
self - собственная личность, сам
selfish - эгоистичный
self-same - тот же самый
sell - продавать
send - посылать
senior - старший
sense - чувство
sense - разум
senseless - бесчуственный или бессодержательный, бессмысленный
sensibility - чувствительность, восприимчивость
sensible - разумный, здравомыслящий
sensitive - чувствительный, восприимчивый
sensual - плотский
sentence - приговор
sentence - предложение
sentiment - чувство, настроение, мнение
separate - отделять
separation - отделение, расставание
sequel - продолжение
series - ряд,серия
serious - серьёзный
sermon - проповедь
servant - слуга
serve - подавать еду
serve - служить
service - служба, услуга, обслуживание
set - устанавливать
set - набор, комплект
set out - стремиться
set up - учредить, установить
settle - решать, урегулировать
settle - уладить, решить, определиться
settle for - соглашаться
settlement - урегулирование, решение
several - несколько
severe - строгий, суровый
sew - шить
sex - пол (м/ж)
shade - тень/затенять
shadow - тень
shake - трясти
shallow - мелкий или поверхностный
shame - стыд, позор
shameful - позорный, постыдный
shape - очертания/придавать форму
share - делить
shark - акула
sharp - острый
sharpen - заострять
shatter - разбивать, разрушать
shave - бриться
shear - стричь
sheath - футляр, ножны
shed - ронять или проливать
sheep - овца
sheer - абсолютный, полнейший
sheet - лист бумаги, стекла, ткани и т. д.
shelf - полка
shell - оболочка, скорлупа, раковина
shepherd - пастух
shield - щит
shift - менять, перемещать/смена, перемещение
shine - сияние/сиять
ship - корабль
shirk - увиливать, уклоняться
shit - дерьмо
shiver - дрожать/дрожь
shock - потрясать/потрясение, шок
shoe - туфля
shoot - стрелять
shop - магазин/ходить по магазинам
shore - берег моря, озера
shortage - недостаток
shortcut - кратчайший путь
shorten - укорачивать
shot - выстрел
shoulder - плечо
shout - кричать/крик
shove - толкать, пихать/толчок
shovel - лопата, совок/копать
shower - душ
shred - лоскуток, клочок/резать, кромсать
shrewd - проницательный, умный, практичный
shrink - сокращаться, сжиматься, усыхать
shroud - пелена, покров, саван
shudder - вздрагивать/содрогание
shut - закрывать/закрытый
shut up - заткнуться
shy - застенчивый
sick - больной
sicken - испытывать отвращение или заболевать
sickness - болезнь
side - сторона
sidewalk - тротуар
sigh - вздыхать/вздох
sight - вид, зрелище/видеть, наблюдать
sign - знак, признак
sign - подписывать
sign up - записаться, поступить куда-либо
signature - подпись
significance - значение, важность
significant - значительный
signify - означать, иметь значение
silence - тишина или молчание
silent - тихий или молчаливый
silk - шёлк/шёлковый
silly - глупый
silver - серебряный/серебро
similar - похожий
simple - простой
simplicity - простота
simplify - упрощать
simply - просто
simultaneous - одновременный
sin - грех/грешить
since - с (каких-то пор)
since - так как, потому что
sincere - искренний
sincerity - искренность
single - одинокий, одиночный, один-единственный
singular - необычный, исключительный
singularity - оригинальность, необычность
sink - тонуть или топить (обычно о корабле)
sink - раковина или сточная труба
sip - потягивать, попивать/маленький глоток
size - размер
skate - кататься на коньках/конёк
skeleton - скелет
sketch - набросок, рисунок, эскиз
ski - ехать на лыжах/лыжа
skill - умение, искусство
skilled - умелый, квалифицированный
skillful - умелый
skin - кожа, шкура/снимать шкуру
skinny - тощий
skip - пропускать
skirt - юбка
skull - череп
sky - небо
slack - слабый, дряблый, вялый
slacken - ослаблять
slam - хлопать, бросать со стуком
slander - клевета, злословие
slap - шлепок/шлёпать, хлопать
slaughter - резня, бойня/устраивать бойню
slave - раб
slavery - рабство
slay - убивать
sleeve - рукав
slender - скудный, слабый
slice - ломтик, кусочек/резать на кусочки
slide - скользить/скольжение
slight - незначительный, лёгкий, слабый
slim - тонкий, стройный/похудеть
slip - поскользнуться/скольжение, сдвиг, смещение
slippers - тапочки
slippery - скользкий
slope - наклон, склон, скат
sloth - лень, медлительность
slow - медленный
slump - резко падать/резкое падение (обычно о показателях)
sly - хитрый, ловкий
smack - хлопать, шлёпать/хлопание
smart - умный, ловкий, проворный
smash - разбивать, сокрушать, сталкивать/разрушение, падение
smell - пахнуть или нюхать
smoke - курить
smoke - дым
smooth - гладкий
snake - змея
snap - трещать, щёлкать, порваться/треск, щёлканье
snap into - торопиться приняться за работу
snatch - схватить/хватание
snatch away - утащить
sneak - красться
sneer - насмешка, глумление/презрительно насмехаться
sneeze - чихать/чихание
sniff - сопеть/сопение
snow - снег/снежный
snub - оскорблять, относиться с пренебрежением/пренебрежительное отношение
soak - впитываться, просачиваться, всасывать
soap - мыло
soar - парить, высоко летать
sober - трезвый/отрезвлять, трезветь
so-called - так называемый
soccer - футбол
sociable - общительный, дружелюбный
society - общество
sock - носок
sodomy - педерастия
soft - мягкий
soften - смягчать
software - программное обеспечение
soil - почва
solar - солнечный
soldier - солдат
sole - единственный, исключительный
solemn - торжественный, важный, серьёзный
solid - твёрдый
solitary - одинокий, уединённый или единичный
solitude - уединение или одиночество
solution - решение
solve - решать (проблему)
someday - как-нибудь
somehow - как-нибудь, как-то
sometime - когда-нибудь или когда-то
somewhat - отчасти, до некоторой степени
somewhere - где-нибудь, куда-нибудь
soon - рано
soon - скоро
soothe - успокаивать, смягчать
sophisticated - сложный, запутанный, изощрённый
sore - огорчённый, опечаленный
sore - больной
sorrow - горе
sorry - огорчённый, сожалеющий
soul - душа
sound - здоровый
sound - звук/звучать, произносить
soup - суп
sour - кислый
source - источник
south - юг
southern - южный
sow - сеять
space - космос
space - место, пространство
spacecraft - космический корабль
spaceship - космический корабль
spade - лопата/копать лопатой
span - промежуток времени
spare - уберечь, сберечь/сбережённый, сэкономленный
sparing - скудный, умеренный
spark - искра/искриться
sparkle - искра/искриться
sparrow - воробей
speak up - высказаться
spear - копьё
special - особенный
specialty - специальность или особенность
species - вид, порода, разновидность
spectacle - зрелище
spectacular - эффектный, захватывающий
spectator - зритель, очевидец
speculate - размышлять, делать предположения
speculation - размышление, теория, предположение
speech - речь
speed - скорость
speed - торопить или ускоряться
spell - писать по буквам
spelling - правописание, орфография
spend - тратить или проводить (о времени)
spider - паук
spill - проливать
spin - крутиться
spine - позвоночник
spirit - дух
spiritual - духовный
spit - плевать
spite - злоба
spiteful - злобный
splash - брызгать/брызги, всплеск
splendid - великолепный, блестящий
split - раскалывать, разбиваться, разъединяться, рассыпаться
spoil - портить
spokesman - представитель, делегат, оратор
spoon - ложка
spot - пятно
spot - место
spot - увидеть, узнать, опознать
spouse - супруг, супруга
spread - распространять, расширять/распространение, расширение
spring - прыгать/прыжок
spring - весна
spring - происходить от чего-либо
sprint - бегать/бег на короткие дистанции
spur - мотивировать, побуждать/шпора
spy - шпион/шпионить
square - площадь
square - квадрат/квадратный
squat - сидеть (сленг или о животных)
squeak - скрипеть/скрип
squeeze - сжимать, выжимать, вынуждать/сжатие
stab - убивать ножом/удар ножом
stable - стойкий, устойчивый
stack - куча, груда
staff - штат, персонал
stage - стадия, ступень
stagger - шататься/шатание
stain - пятно
stair - ступенька
stake - рисковать, ставить на кон
stalk - стебель
stall - застревать, останавливать, задерживать
stamp - штамп, печать, марка
stand - выдержать, выстоять
stand up for - защищать, отстаивать
standpoint - точка зрения
standstill - останока, бездействие, застой
stare - пристально смотреть/пристальный взгляд
stark - полный, абсолютный
startle - пугать или удивлять/испуг
startling - потрясающий, поразительный
starvation - голод
starve - голодать
state - состояние, положение
state - государство/государственный
state - утверждать, констатировать, формулировать
statement - утверждение, заявление, изложение
statesman - государственный деятель
static - неподвижный
stay - оставаться, стоять на месте
stay up - не ложиться спать
steady - устойчивый
steal - красть/воровство
steam - пар
steel - сталь
steep - крутой
steer - управлять (судном, автомобилем)
stellar - звёздный
stem - стебель, черенок/происходить от
step - шаг/шагать, наступать
sterile - бесплодный, безрезультатный
stern - суровый, неумолимый
stick - палка
stick - приклеиваться
stick - держаться, приклеиться, застрять
stick - совать, тыкать
stick out - высовывать, торчать
stick up - выдаваться, торчать
sticker - наклейка
stiff - тугой, негибкий
stifle - сдерживать, подавлять или душить
still - всё ещё
still - тихий, бесшумный, спокойный, неподвижный
stimulus - стимул, импульс
sting - жало/жалить
stink - вонять
stir - шевелить(ся)
stock - акции
stock - склад/хранить
stomach - желудок
stone - камень
storage - хранилище или хранение
store - склад товаров или магазин/хранить
storey - этаж, ярус
storm - буря
story - рассказ, история
stout - полный, тучный, плотный
straight - прямой/прямо
straightforward - прямой, честный
strain - напряжение, натяжение, испытание/напрягать, натягивать
strain - мелодия, напев, стих
strange - необычный или чужой
strangle - душить или задыхаться
strap - ремень
straw - солома
strawberry - земляника, клубника
stray - блуждать
stream - поток, река, ручей/течь
strength - сила, прочность
strengthen - усиливать
stress - напряжение, давление
stretch - тянуть, вытягивать/вытягивание
strict - точный, строгий
stride - шагать/большой шаг
strife - борьба, спор, раздор
strike - забастовка
strike - удар/ударить, поразить (в т. ч. перен.)
string - тонкая верёвка или струна
strip - обнажать, сдирать
stripe - полоска
strive - стараться, бороться
stroke - гладить, ласкать
stroll - прогулка/прогуливаться
struggle - бороться/борьба
stubborn - упрямый
study - учиться, изучать
stuff - набивать, заполнять, заваливать
stuff - материал, вещество, вещи и всё что угодно)
stumble - споткнуться/спотыкание
stupid - тупой, глупый
stupidity - глупость
sturdy - сильный, здоровый
subdue - подчинять, покорять
subject - предмет, тема, вопрос
subject - подверженный
sublime - высокий, высший
submission - подчинение
submit - подчиниться, покориться
subordinate - подчинённый/подчинять
subscribe - подписываться
subsequent - последующий
substance - вещество, сущность, суть
substantial - реальный, существенный
substitute - замена, заместитель, суррогат
substitution - замена, замещение
subtle - тонкий, неуловимый, искусный
subtract - вычитать
suburb - пригород
subway - метро
succeed - достигать цели, успеха
success - успех
successful - успешный
succession - последовательность
successive - последовательный
successor - преемник, последователь
suck - сосать
sucker - любое ругательное слово)
sudden - внезапный
sue - возбуждать дело, преследовать судебным порядком
suffer - страдать
suffice - быть достаточным, хватать
sufficient - достаточный
sugar - сахар
suggest - предлагать
suggestion - предложение
suicide - самоубийство
suit - костюм
suit - подходить, соответствовать
suitable - подходящий
suitcase - чемодан
sum - сумма/складывать, подводить итог
summary - краткое изложение, сводка
summer - лето
summit - вершина
summon - собирать, созывать
sun - солнце
sunset - закат солнца
sunshine - солнечный свет
superb - великолпный, прекрасный, превосходный
superior - высший, лучший, старший, превосходящий
superiority - превосходство
superstition - суеверие
supplement - добавление, прибавление
supply - поставка, снабжение или предложение (экон)
support - поддерживать/поддержка
suppose - предполагать, подразумевать
supposition - предположение
suppress - пресекать, подавлять, сдерживать
supreme - верховный, высший
sure - верный, уверенный
surface - поверхность
surge - подниматься, вздыматься, волноваться
surgeon - хирург
surgery - хирургия
surgical - хирургический
surmount - преодолевать
surpass - превосходить, превышать
surplus - излишек/излишний
surprise - удивление/удивлять
surrender - сдаваться/сдача, капитуляция
surround - окружать
surrounding - окружение
survey - обзор, осмотрение/обозревать
survival - выживание
survive - выживать
survivor - оставшийся в живых
suspect - подозревать/подозреваемый
suspend - подвешивать, приостанавливать, временно прекращать
suspense - неизвестность, неопределённость, временное прекращение, подвешенность
suspicion - подозрение
suspicious - подозрительный
sustain - поддерживать, подкреплять
swallow - глотать/глоток
swap - менять/обмен
sway - влиять, воздействовать
sway - качаться, колебаться/качание
swear - клясться/клятва
swear - ругаться
sweat - пот/потеть
sweep - мести/подметание
sweet - приятный, прекрасный, сладкий
sweetheart - возлюбленная(ый) или дорогая(ой) (в обращении)
swell - надуваться, увеличиваться
swell - отличный, превосходный
swift - скорый, быстрый
swindle - обманывать/надувательство
swing - качать, махать/качание, колебание
switch - переключатель/переключать, включать (электричество)
sword - меч
symbol - символ, обозначение
sympathize - сочувствовать
sympathy - сочувствие
table - таблица
tackle - схватить, взяться
tag - ярлык, этикетка, бирка
tail - хвост
take - занимать (о времени, ресурсах)
take away - отбирать, забирать
take care - заботиться
take down - сносить, разрушать, спускать
take off - снимать (одежду)
take risks - рисковать
tale - сказка
talent - талант
talker - болтун
tall - высокий
tame - ручной/приручать, смирять
tan - загар, загорать
tangle - запутывать/путаница, узел
tank - бак, чан, цистерна
tap - стучать, похлопывать/стук
tape - тесьма, лента
target - цель
task - задача, задание
taste - вкус/иметь вкус
taunt - насмехаться/насмешка
tax - налог/облагать налогом
taxation - налогообложение
tea - чай
team - команда, экипаж
tear - рвать
tears - слёзы
tease - дразнить
technology - техника
tedious - скучный, утомительный
teenage - подросткового возраста
temper - характер или настроение
temperance - умеренность, воздержанность
temple - храм
temporal - временный, текущий, мирской
temporary - временный
tempt - соблазнять, искушать
temptation - искушение
tenacity - упорство, стойкость, цепкость
tenant - съёмщик квартиры
tend - иметь склонность, стремиться
tendency - тенденция
tender - нежный,
tenet - догмат, принцип
tense - натянутый, тугой, напряжённый
tension - напряжение
tent - палатка
tentative - пробный, экспериментальный
term - термин, язык
term - срок, период
termination - конец, завершение
terms - отношения
terrible - ужасный
terrific - ужасающий, в т. ч. перен.: огромный, необычный
terrify - ужасать, запугивать
terror - страх, ужас
terrorize - вселять страх
test - проверить, испытать/проверка
testicles - яички
testify - утверждать, заявлять
testimony - доказательство, свидетельство
thank - благодарить/благодарность
thankful - благодарный
theater - театр
theft - воровство, кража
theme - тема
theory - теория
thereafter - потом, в последствии
thereby - таким образом, в связи с этим
therefore - поэтому, следовательно
these - эти
thick - толстый
thickness - толщина
thief - вор
thin - тонкий, худой, слабый, тусклый
thirst - жажда
thorn - шип, колючка
thoroughly - вполне, основательно
those - те
thou - ты (устар)
though - хотя, несмотря на
thought - мысль
thoughtful - задумчивый, вдумчивый
thousand - тысяча
thread - нить
threat - угроза
threaten - угрожать
threshold - порог
thrift - экономность, бережливость
thrill - волнение, дрожь/волновать, вызывать трепет
thrive - процветать, преуспевать
throat - глотка
throng - толпа, масса, множество
throughout - повсюду, на всём протяжении
throw - бросать
throw away - выбрасывать, отбрасывать
throw out - выбрасывать
thrust - толкать, тыкать, совать/толчок
thumb - большой палец руки
thump - ударять, бить с глухим звуком/глухой удар
thunder - гром
thunderstorm - гроза
thus - так, таким образом
ticket - билет
tide - прилив
tidy - опрятный, аккуратный
tie - связь, соединение/завязывать, привязывать
tiger - тигр
tight - плотный, тугой/туго
tighten - натягивать, сжимать, уплотнять
till - до тех пор, пока
timber - лесоматериалы, брёвна
time - раз
timely - своевременный
timid - робкий, застенчивый
tin - жесть/жестяной
tiny - маленький, крошечный
tip - кончик
tips - чаевые
tire - утомлять, надоедать
tiresome - утомительный, скучный
tissue - ткань (биол. и техн.)
title - название
tobacco - табак
toe - палец ноги
toil - тяжёлый труд/усиленно трудиться
toilet - туалет
token - знак
tolerance - терпимость
tolerant - терпимый (человек)
tolerate - терпеть
toleration - терпимость
toll - плата, пошлина, удержания, потери
tomb - могила
ton - тонна
tongue - язык
tonight - сегодня вечером
tool - инструмент
tooth - зуб
toothpaste - зубная паста
top - верх/верхний
topic - тема
torment - мучение, мука
torn - рваный
torture - пытка/пытать, мучить
toss - бросать/бросание
total - весь, совокупный/целое, итог
totally - полностью
touch - трогать, касаться
tough - жёсткий, трудный, упрямый
tow - тянуть на буксире/буксировка
toward - в сторону, по направлению к
towel - полотенце
tower - башня
town - небольшой город
toy - игрушка
trace - след/следить
track - след, курс, путь
trade - торговать/торговля
trade - ремесло, профессия
traffic - уличное движение
trail - след, тропа/тащиться, волочиться по следу
train - обучать, воспитывать, тренировать
train - поезд
trait - черта, особенность
traitor - предатель
tranquil - спокойный
tranquility - спокойствие
transaction - дело, ведение дела
transfer - перемещение, перевод/передавать, перемещать
transform - превращать(ся), изменять(ся)
transition - переход, перемещение
translate - преобразовывать, переводить на другой язык, объяснять
transmission - передача
transmit - передавать, отправлять
transparent - прозрачный
trap - западня, ловушка/ловить в ловушку
trash - отбросы, мусор
travel - путешествовать
tray - поднос, поддон
treacherous - предательский
treachery - предательство
tread - ступать/поступь, походка
treason - предательство
treasure - сокровище
treat - обращаться с
treat - лечить
treatment - обращение с чем-либо
treaty - договор
tree - дерево
tremble - дрожь, дрожание/дрожать, трястись
tremendous - огромный, страшный
trend - направление, тенденция
trial - пробный/испытание, проба
trial - судебный процесс
tribe - племя
tribute - дань
trick - трюк, хитрость, обман/обманывать
trickery - надувательство, хитрость
trifle - пустяк, мелочь
trifling - пустяковый
trigger - курок
trim - подрезать, приводить в порядок
trip - путешествие
triple - тройной/утраивать
trivial - обыденный, мелкий, пустой
troops - войска
trophy - трофей, добыча
trouble - неприятность или беспокойство/тревожить, затруднять, надоедать
troublemaker - нарушитель спокойствия
troublesome - мучительный, причиняющий беспокойство
truce - мир, перемирие
truck - грузовик
true - верный, истинный
truly - поистине, по настоящему
trumpet - труба (музыкальный инструмент)
trunk - ствол дерева
trust - доверять
truth - правда
truthful - правдивый, верный
try - пробовать, испытывать, пытаться
trying - трудный, тяжёлый, мучительный
tube - трубка, тюбик
tug - тащить, дёргать
tuition - обучение или плата за обучение
tumble - падение или беспорядок, смятение
tune - мелодия, мотив
turmoil - шум, беспорядок, суматоха
turn - изменить, превратить
turn - поворачивать, вращать/поворот
turn aside - отклоняться, отворачиваться, отходить в сторону
turn back - возвращаться, разворачиваться вспять
turn down - отвергнуть, отклонить
turn into - превращать(ся) в
turn off - выключать
turn on - включать
turn out - оказаться
turnover - оборот (экон.)
turtle - черепаха
twice - дважды
twilight - сумерки
twin - близнец
twist - крутить, изгибать/изгиб, поворот
tyrant - тиран
ugliness - уродство, некрасивая внешность
ugly - уродливый
ultimate - окончательный, конечный
umbrella - зонтик
unable - неспособный
unacceptable - неприемлемый
unalterable - неизменный
unarmed - безоружный
unaware - не знающий, не подозревающий
unbearable - невыносимый
unbelievable - невероятный
unbending - несгибаемый
uncertainty - неопределённость
uncle - дядя
uncommon - необыкновенный, необычный
unconscious - бессознательный, неосознанный или не осознающий
uncover - раскрывать
underestimate - недооценивать
undergo - подвергаться
underground - подполье/подпольный, тайный
underlying - лежащий в основе
undermine - подрывать, подмывать
underneath - внизу, ниже
underrate - недооценивать
undertake - предпринимать
underwear - нижнее бельё
undo - сделать обратно
undone - несделанный
uneasy - неспокойный
unemployment - безработица
unequal - неравный
unequality - неравенство
unfair - нечестный
unfit - неподходящий
unfold - разворачивать
unfortunate - несчастливый, неудачный
unfortunately - к несчастью
unhappy - несчастливый, неудачный
unidentified - неопознанный
unification - объединение
uniform - униформа
unintelligible - непонятный, неразборчивый
union - союз
unique - уникальный
unit - единица, единица измерения
unite - объединять
unity - единство
universal - всеобщий, всемирный
universe - вселенная
unjust - несправедливый
unknown - неизвестный
unless - если не
unlike - в отличие от
unlikely - неправдоподобный, маловероятный
unlimited - неограниченный
unlock - отпереть
unpleasant - неприятный
unruffled - спокойный, ровный
unseen - невидимый
unskilled - неумелый
unsolvable - нерешаемый
unstable - нетвёрдый, неустойчивый, колеблющийся
unthinkable - немыслимый
untie - отвязывать, развязывать
until - до тех пор, пока
untrue - неверный, ложный
untruth - неправда
unusual - обычный
unworthy - недостойный
up to - в соответствии с
upbringing - воспитание
update - обновление/обновлять
upper - верхний
upright - честный
upset - опрокидывать/опрокитывание, беспорядок
upside down - вверх ногами
upward - направленный вверх
upwards - вверх
urban - городской
urge - побуждать, подстрекать, убеждать
urgency - настойчивость, срочность
urgent - срочный, крайне необходимый
use - использовать, пользоваться
useful - полезный
useless - бесполезный
usual - обычный
utility - полезность
utmost - крайний, предельный, величайший
utter - издавать (звук)
utter - абсолютный, полный
vacant - незанятый, свободный
vacation - отпуск
vacuum cleaner - пылесос
vague - смутный, неясный, неуловимый
vain - тщетный, напрасный
valid - веский, обоснованный
valley - долина
valuable - ценный, дорогой
value - ценность
vanish - исчезать
vanity - тщеславие
vanquish - побеждать, покорять
variable - переменный, переменная (мат)
variation - изменение, вариант, отклонение
variety - многообразие
various - различный
vary - разниться, расходиться, варьироваться
vast - обширный, многочисленный
vegetable - овощ
vehicle - средство транспорта, проводник, средство распространения
vein - вена, кровеносный сосуд
velocity - скорость
velvet - бархат
vengeance - месть
venture - рискнуть, отважиться/рискованное мероприятие
verb - глагол
verbal - словесный, устный
verge - край, грань
verification - проверка, подтверждение
verify - проверять
verse - стихи
vessel - судно, корабль
vessel - сосуд
vex - раздражать, беспокоить
via - через
vice - порок, недостаток
vice versa - наоборот
vicious - злобный, порочный, ужасный
victim - жертва
victor - победитель
victorious - победоносный
victory - победа
view - вид, взгляд/осматривать
vigorous - сильный, энергичный
vile - подлый, низкий
village - деревня
villain - негодяй
vindictive - мстительный
vine - виноградная лоза
violate - нарушать
violation - нарушение
violence - насилие
violent - неистовый, яростный, интенсивный, страстный и т. д.
violin - скрипка
viper - гадюка
virgin - девственница, девственник
virtual - фактический, действительный
virtue - добродетель, достоинство
virtuous - добродетельный, целомудренный
visible - видимый
vision - видение
visit - посетить/посещение
visualize - представлять, видеть мысленно
vital - жизненно важный, насущный
vivid - яркий, живой
vocational - профессиональный
voice - голос
void - пустой, бесполезный, недействительный
volume - полнота, объём, громкость
volume - том, книга
voluntary - добровольный
vomit - блевать/рвота
vote - голосовать
vow - клятва/клясться
voyage - путешествие
vulgar - пошлый, грубый
wag - махать, качать
wage - зарплата
waist - талия
waiter - официант
wake up - просыпаться или будить
waking - бодрствующий, проведённый не во сне
walk - идти пешком
wall - стена
wallet - бумажник
wander - бродить, блуждать, заблудиться
wane - идти на убыль/убывание
war - война
warehouse - товарный склад или большой магазин
warfare - война, искусство войны
warm - тёплый/греть
warmth - тепло
warn - предупреждать, предостерегать
warning - предупреждение
warrant - оправдывать, подтверждать
warrior - воин
wary - осторожный, подозрительный
wash - мыть
wasp - оса
waste - тратить впустую/потери, убытки
watch - смотреть
watch - наручные или карманные часы
watch over - охранять, следить
waterfall - водопад
wave - волна/размахивать
waver - колебаться, колыхаться
wax - воск
way - способ, путь
weak - слабый
weaken - ослаблять
weakness - слабость
wealth - богатство, изобилиие
wealthy - богатый, состоятельный
weapon - оружие
wear - носить
wear off - стираться, проходить
wear out - износить, истощить, изнурить
weariness - усталость
weary - утомлённый/утомляться
weather - погода
wedding - свадьба
weed - сорняк
week - неделя
weekly - еженедельный
weep - плакать
weigh - весить
weight - вес
weird - причудливый
welcome - желанный, приятный/гостеприимство или приветствие
welfare - благоденствие
well - колодец
west - запад
western - западный
wet - мокрый
whale - кит
whatever - что бы ни, какой бы ни, и т. д.
wheat - пшеница
wheel - колесо
whence - откуда
whenever - всякий раз когда
whereabouts - местонахождение
whereas - тогда как
whereby - посредством чего
wherever - где бы ни
whether - ли
while - в то время как
whim - прихоть, причуда
whine - вой, хныканье/скулить
whip - кнут
whirl - вертеться, кружиться
whisper - шептать/шёпот
whistle - свистеть/свист или свисток
whitewash - обелять, скрывать недостатки
whither - куда
whoever - кто бы ни, тот кто
whole - весь, целый
wholesale - оптовая продажа
wholly - полностью, целиком
whore - шлюха, блядь
wicked - злой, грешный, свирепый, опасный
wide - широкий
widen - расширять
widespread - широко распространённый
widow - вдова
width - ширина
wield - владеть, иметь в руках
wife - жена
wild - дикий
wilderness - дикое место, пустыня
wildlife - дикая природа
will - воля или сила воли
willing - готовый, охотно делающий
willingness - готовность
willow - ива
wily - лукавый, хитрый, коварный
win - побеждать, выигрывать
wind - ветер
wine - вино
wing - крыло
wink - подмигивать, мограть/подмигивание
winter - зима
wipe - вытирать
wipe out - уничтожить
wire - провод
wireless - беспроводной
wisdom - мудрость
wise - мудрый
wish - желать/желание
wit - ум, разум
withdraw - уходить, удаляться, брать назад и т. д.
wither - вянуть, сохнуть, ослабевать
within - внутри, в пределах
witness - свидетель/быть очевидцем
witty - остроумный
wizard - волшебник
woe - горе, несчастье
wolf - волк
wonder - удивление или чудо/удивляться
wonder - интересоваться, желать знать
wonderful - удивительный
wont - имеющий обыкновение
woo - ухаживать, добиваться
wood - дрова, дерево
wood - лес
wooden - деревянный
wool - шерсть
wordy - словесный
worm - червяк
workshop - мастерская
worry - беспокоиться/тревога
worship - поклоняться, почитать/почитание, культ
worst - наихудший
worth - стоящий, заслуживающий
worthless - ничего не стоящий, никудышний, бесполезный
worthy - достойный
wound - рана
wrangle - спорить, пререкаться/спор, ссора
wrap - заворачивать/обёртка
wrath - гнев, ярость
wreck - крушение, авария/терпеть крушение, рухнуть
wrest - искажать, истолковывать
wrestle - бороться
wretched - несчастный, жалкий
wring - терзать, выжимать, скручивать
wrinkle - морщина/сморщиться
wrist - запястье
writing - надпись
wrong - неверный
wrong-headed - заблуждающийся
yacht - яхта
yard - двор
yawn - зевать/зевота
yearly - ежегодный
yearn - томиться, тосковать, жаждать, стремиться
yell - пронзительный крик/кричать
yelp - лаять, визжать
yet - тем не менее
yield - поддаваться, уступать
young - молодой
youngster - юноша
youth - юность, молодёжь или юноша
zeal - рвение, усердие
zealous - рьяный, усердный
zoo - зоопарк 
